methode;type;threshold;nom_instance;N;M;F;tps;solv;obj;obj1;obj2;obj22;setup;valide;feas;opt 
jobBased.exe;T14_big;big;instance_20_3_4_10_8_Bthr_0.txt;20;3;4;600.007;1;433;429;4;4;2;1;1;0
jobBased.exe;T14_big;big;instance_20_3_4_10_8_Bthr_1.txt;20;3;4;600.005;1;337;337;0;0;1;1;1;0
jobBased.exe;T14_big;big;instance_20_3_4_10_8_Bthr_2.txt;20;3;4;600.007;1;264;262;2;2;1;1;1;0
jobBased.exe;T14_big;big;instance_20_3_4_10_8_Bthr_3.txt;20;3;4;600.006;1;411;410;1;1;4;1;1;0
jobBased.exe;T14_big;big;instance_20_3_4_10_8_Bthr_4.txt;20;3;4;600.006;1;480;476;4;4;2;1;1;0
jobBased.exe;T14_big;big;instance_20_3_4_10_8_Bthr_5.txt;20;3;4;600.006;1;227;223;4;4;2;1;1;0
jobBased.exe;T14_big;big;instance_20_3_4_10_8_Bthr_6.txt;20;3;4;600.007;1;413;413;0;0;4;1;1;0
jobBased.exe;T14_big;big;instance_20_3_4_10_8_Bthr_7.txt;20;3;4;600.006;1;429;426;3;3;4;1;1;0
jobBased.exe;T14_big;big;instance_20_3_4_10_8_Bthr_8.txt;20;3;4;600.006;1;437;432;5;5;1;1;1;0
jobBased.exe;T14_big;big;instance_20_3_4_10_8_Bthr_9.txt;20;3;4;600.005;1;427;425;2;2;3;1;1;0
jobBased.exe;T14_medium;medium;instance_20_3_4_10_8_Mthr_0.txt;20;3;4;600.006;1;141;141;0;0;3;1;1;0
jobBased.exe;T14_medium;medium;instance_20_3_4_10_8_Mthr_1.txt;20;3;4;600.005;1;370;363;7;7;2;1;1;0
jobBased.exe;T14_medium;medium;instance_20_3_4_10_8_Mthr_2.txt;20;3;4;600.006;1;322;318;4;4;2;1;1;0
jobBased.exe;T14_medium;medium;instance_20_3_4_10_8_Mthr_3.txt;20;3;4;600.005;1;148;143;5;5;2;1;1;0
jobBased.exe;T14_medium;medium;instance_20_3_4_10_8_Mthr_4.txt;20;3;4;600.006;1;211;211;0;0;5;1;1;0
jobBased.exe;T14_medium;medium;instance_20_3_4_10_8_Mthr_5.txt;20;3;4;600.005;1;610;606;4;4;2;1;1;0
jobBased.exe;T14_medium;medium;instance_20_3_4_10_8_Mthr_6.txt;20;3;4;600.006;1;328;328;0;0;4;1;1;0
jobBased.exe;T14_medium;medium;instance_20_3_4_10_8_Mthr_7.txt;20;3;4;600.006;1;360;357;3;3;3;1;1;0
jobBased.exe;T14_medium;medium;instance_20_3_4_10_8_Mthr_8.txt;20;3;4;600.005;1;427;424;3;3;3;1;1;0
jobBased.exe;T14_medium;medium;instance_20_3_4_10_8_Mthr_9.txt;20;3;4;600.006;1;341;337;4;4;2;1;1;0
jobBased.exe;T14_small;small;instance_20_3_4_10_8_Sthr_0.txt;20;3;4;600.005;1;384;379;5;5;4;1;1;0
jobBased.exe;T14_small;small;instance_20_3_4_10_8_Sthr_1.txt;20;3;4;600.005;1;367;363;4;4;3;1;1;0
jobBased.exe;T14_small;small;instance_20_3_4_10_8_Sthr_2.txt;20;3;4;600.006;1;278;273;5;5;2;1;1;0
jobBased.exe;T14_small;small;instance_20_3_4_10_8_Sthr_3.txt;20;3;4;600.006;1;366;363;3;3;5;1;1;0
jobBased.exe;T14_small;small;instance_20_3_4_10_8_Sthr_4.txt;20;3;4;600.006;1;176;172;4;4;5;1;1;0
jobBased.exe;T14_small;small;instance_20_3_4_10_8_Sthr_5.txt;20;3;4;600.005;1;307;303;4;4;5;1;1;0
jobBased.exe;T14_small;small;instance_20_3_4_10_8_Sthr_6.txt;20;3;4;600.005;1;278;273;5;5;3;1;1;0
jobBased.exe;T14_small;small;instance_20_3_4_10_8_Sthr_7.txt;20;3;4;600.007;1;191;187;4;4;3;1;1;0
jobBased.exe;T14_small;small;instance_20_3_4_10_8_Sthr_8.txt;20;3;4;600.005;1;409;404;5;5;3;1;1;0
jobBased.exe;T14_small;small;instance_20_3_4_10_8_Sthr_9.txt;20;3;4;600.005;1;343;338;5;5;3;1;1;0
jobBased.exe;T15_big;big;instance_20_3_5_10_9_Bthr_0.txt;20;3;5;600.006;1;292;292;0;0;3;1;1;0
jobBased.exe;T15_big;big;instance_20_3_5_10_9_Bthr_1.txt;20;3;5;600.007;1;369;369;0;0;2;1;1;0
jobBased.exe;T15_big;big;instance_20_3_5_10_9_Bthr_2.txt;20;3;5;600.006;1;428;422;6;6;2;1;1;0
jobBased.exe;T15_big;big;instance_20_3_5_10_9_Bthr_3.txt;20;3;5;600.006;1;267;267;0;0;4;1;1;0
jobBased.exe;T15_big;big;instance_20_3_5_10_9_Bthr_4.txt;20;3;5;600.005;1;667;662;5;5;2;1;1;0
jobBased.exe;T15_big;big;instance_20_3_5_10_9_Bthr_5.txt;20;3;5;600.006;1;376;376;0;0;3;1;1;0
jobBased.exe;T15_big;big;instance_20_3_5_10_9_Bthr_6.txt;20;3;5;600.006;1;358;356;2;2;4;1;1;0
jobBased.exe;T15_big;big;instance_20_3_5_10_9_Bthr_7.txt;20;3;5;600.006;1;323;323;0;0;4;1;1;0
jobBased.exe;T15_big;big;instance_20_3_5_10_9_Bthr_8.txt;20;3;5;600.005;1;294;294;0;0;3;1;1;0
jobBased.exe;T15_big;big;instance_20_3_5_10_9_Bthr_9.txt;20;3;5;600.005;1;251;243;8;8;3;1;1;0
jobBased.exe;T15_medium;medium;instance_20_3_5_10_9_Mthr_0.txt;20;3;5;600.005;1;284;277;7;7;4;1;1;0
jobBased.exe;T15_medium;medium;instance_20_3_5_10_9_Mthr_1.txt;20;3;5;600.006;1;405;399;6;6;2;1;1;0
jobBased.exe;T15_medium;medium;instance_20_3_5_10_9_Mthr_2.txt;20;3;5;600.006;1;468;465;3;3;4;1;1;0
jobBased.exe;T15_medium;medium;instance_20_3_5_10_9_Mthr_3.txt;20;3;5;600.005;1;347;339;8;8;2;1;1;0
jobBased.exe;T15_medium;medium;instance_20_3_5_10_9_Mthr_4.txt;20;3;5;600.005;1;232;232;0;0;4;1;1;0
jobBased.exe;T15_medium;medium;instance_20_3_5_10_9_Mthr_5.txt;20;3;5;600.005;1;349;342;7;7;2;1;1;0
jobBased.exe;T15_medium;medium;instance_20_3_5_10_9_Mthr_6.txt;20;3;5;600.006;1;408;404;4;4;4;1;1;0
jobBased.exe;T15_medium;medium;instance_20_3_5_10_9_Mthr_7.txt;20;3;5;600.005;1;321;317;4;4;3;1;1;0
jobBased.exe;T15_medium;medium;instance_20_3_5_10_9_Mthr_8.txt;20;3;5;600.006;1;419;416;3;3;5;1;1;0
jobBased.exe;T15_medium;medium;instance_20_3_5_10_9_Mthr_9.txt;20;3;5;600.005;1;353;346;7;7;3;1;1;0
jobBased.exe;T15_small;small;instance_20_3_5_10_9_Sthr_0.txt;20;3;5;600.006;1;470;466;4;4;6;1;1;0
jobBased.exe;T15_small;small;instance_20_3_5_10_9_Sthr_1.txt;20;3;5;600.006;1;343;338;5;5;4;1;1;0
jobBased.exe;T15_small;small;instance_20_3_5_10_9_Sthr_2.txt;20;3;5;600.006;1;387;381;6;6;4;1;1;0
jobBased.exe;T15_small;small;instance_20_3_5_10_9_Sthr_3.txt;20;3;5;600.005;1;687;681;6;6;3;1;1;0
jobBased.exe;T15_small;small;instance_20_3_5_10_9_Sthr_4.txt;20;3;5;600.005;1;472;465;7;7;2;1;1;0
jobBased.exe;T15_small;small;instance_20_3_5_10_9_Sthr_5.txt;20;3;5;600.005;1;424;419;5;5;3;1;1;0
jobBased.exe;T15_small;small;instance_20_3_5_10_9_Sthr_6.txt;20;3;5;600.005;1;289;283;6;6;5;1;1;0
jobBased.exe;T15_small;small;instance_20_3_5_10_9_Sthr_7.txt;20;3;5;600.005;1;419;413;6;6;4;1;1;0
jobBased.exe;T15_small;small;instance_20_3_5_10_9_Sthr_8.txt;20;3;5;600.005;1;454;447;7;7;2;1;1;0
jobBased.exe;T15_small;small;instance_20_3_5_10_9_Sthr_9.txt;20;3;5;600.006;1;489;483;6;6;4;1;1;0
jobBased.exe;T16_big;big;instance_20_4_2_10_6_Bthr_0.txt;20;4;2;600.006;1;414;414;0;0;2;1;1;0
jobBased.exe;T16_big;big;instance_20_4_2_10_6_Bthr_1.txt;20;4;2;600.006;1;314;314;0;0;1;1;1;0
jobBased.exe;T16_big;big;instance_20_4_2_10_6_Bthr_2.txt;20;4;2;600.007;1;276;276;0;0;2;1;1;0
jobBased.exe;T16_big;big;instance_20_4_2_10_6_Bthr_3.txt;20;4;2;600.006;1;404;404;0;0;2;1;1;0
jobBased.exe;T16_big;big;instance_20_4_2_10_6_Bthr_4.txt;20;4;2;600.006;1;251;251;0;0;2;1;1;0
jobBased.exe;T16_big;big;instance_20_4_2_10_6_Bthr_5.txt;20;4;2;600.006;1;465;463;2;2;0;1;1;0
jobBased.exe;T16_big;big;instance_20_4_2_10_6_Bthr_6.txt;20;4;2;600.006;1;540;540;0;0;0;1;1;0
jobBased.exe;T16_big;big;instance_20_4_2_10_6_Bthr_7.txt;20;4;2;600.006;1;272;272;0;0;0;1;1;0
jobBased.exe;T16_big;big;instance_20_4_2_10_6_Bthr_8.txt;20;4;2;600.006;1;226;226;0;0;2;1;1;0
jobBased.exe;T16_big;big;instance_20_4_2_10_6_Bthr_9.txt;20;4;2;600.005;1;589;585;4;4;0;1;1;0
jobBased.exe;T16_medium;medium;instance_20_4_2_10_6_Mthr_0.txt;20;4;2;600.005;1;524;524;0;0;2;1;1;0
jobBased.exe;T16_medium;medium;instance_20_4_2_10_6_Mthr_1.txt;20;4;2;600.006;1;95;95;0;0;1;1;1;0
jobBased.exe;T16_medium;medium;instance_20_4_2_10_6_Mthr_2.txt;20;4;2;600.006;1;184;180;4;4;0;1;1;0
jobBased.exe;T16_medium;medium;instance_20_4_2_10_6_Mthr_3.txt;20;4;2;600.007;1;420;420;0;0;2;1;1;0
jobBased.exe;T16_medium;medium;instance_20_4_2_10_6_Mthr_4.txt;20;4;2;600.006;1;268;265;3;3;2;1;1;0
jobBased.exe;T16_medium;medium;instance_20_4_2_10_6_Mthr_5.txt;20;4;2;600.006;1;317;315;2;2;0;1;1;0
jobBased.exe;T16_medium;medium;instance_20_4_2_10_6_Mthr_6.txt;20;4;2;600.006;1;224;224;0;0;2;1;1;0
jobBased.exe;T16_medium;medium;instance_20_4_2_10_6_Mthr_7.txt;20;4;2;600.007;1;422;420;2;2;0;1;1;0
jobBased.exe;T16_medium;medium;instance_20_4_2_10_6_Mthr_8.txt;20;4;2;600.006;1;259;258;1;1;1;1;1;0
jobBased.exe;T16_medium;medium;instance_20_4_2_10_6_Mthr_9.txt;20;4;2;600.006;1;364;364;0;0;1;1;1;0
jobBased.exe;T16_small;small;instance_20_4_2_10_6_Sthr_0.txt;20;4;2;600.007;1;366;365;1;1;1;1;1;0
jobBased.exe;T16_small;small;instance_20_4_2_10_6_Sthr_1.txt;20;4;2;600.007;1;308;306;2;2;0;1;1;0
jobBased.exe;T16_small;small;instance_20_4_2_10_6_Sthr_2.txt;20;4;2;600.006;1;115;111;4;4;0;1;1;0
jobBased.exe;T16_small;small;instance_20_4_2_10_6_Sthr_3.txt;20;4;2;600.006;1;280;280;0;0;2;1;1;0
jobBased.exe;T16_small;small;instance_20_4_2_10_6_Sthr_4.txt;20;4;2;600.007;1;542;540;2;2;0;1;1;0
jobBased.exe;T16_small;small;instance_20_4_2_10_6_Sthr_5.txt;20;4;2;600.005;1;276;275;1;1;1;1;1;0
jobBased.exe;T16_small;small;instance_20_4_2_10_6_Sthr_6.txt;20;4;2;600.006;1;432;430;2;2;0;1;1;0
jobBased.exe;T16_small;small;instance_20_4_2_10_6_Sthr_7.txt;20;4;2;600.006;1;304;303;1;1;2;1;1;0
jobBased.exe;T16_small;small;instance_20_4_2_10_6_Sthr_8.txt;20;4;2;600.005;1;274;270;4;4;0;1;1;0
jobBased.exe;T16_small;small;instance_20_4_2_10_6_Sthr_9.txt;20;4;2;600.006;1;400;399;1;1;1;1;1;0
jobBased.exe;T17_big;big;instance_20_4_3_10_7_Bthr_0.txt;20;4;3;600.006;1;198;198;0;0;0;1;1;0
jobBased.exe;T17_big;big;instance_20_4_3_10_7_Bthr_1.txt;20;4;3;600.006;1;329;329;0;0;2;1;1;0
jobBased.exe;T17_big;big;instance_20_4_3_10_7_Bthr_2.txt;20;4;3;600.006;1;283;283;0;0;2;1;1;0
jobBased.exe;T17_big;big;instance_20_4_3_10_7_Bthr_3.txt;20;4;3;600.006;1;498;497;1;1;1;1;1;0
jobBased.exe;T17_big;big;instance_20_4_3_10_7_Bthr_4.txt;20;4;3;600.005;1;213;213;0;0;1;1;1;0
jobBased.exe;T17_big;big;instance_20_4_3_10_7_Bthr_5.txt;20;4;3;600.006;1;388;388;0;0;1;1;1;0
jobBased.exe;T17_big;big;instance_20_4_3_10_7_Bthr_6.txt;20;4;3;600.005;1;324;322;2;2;2;1;1;0
jobBased.exe;T17_big;big;instance_20_4_3_10_7_Bthr_7.txt;20;4;3;600.006;1;221;221;0;0;3;1;1;0
jobBased.exe;T17_big;big;instance_20_4_3_10_7_Bthr_8.txt;20;4;3;600.006;1;362;362;0;0;2;1;1;0
jobBased.exe;T17_big;big;instance_20_4_3_10_7_Bthr_9.txt;20;4;3;600.006;1;490;487;3;3;0;1;1;0
jobBased.exe;T17_medium;medium;instance_20_4_3_10_7_Mthr_0.txt;20;4;3;600.005;1;336;330;6;6;1;1;1;0
jobBased.exe;T17_medium;medium;instance_20_4_3_10_7_Mthr_1.txt;20;4;3;600.007;1;354;354;0;0;3;1;1;0
jobBased.exe;T17_medium;medium;instance_20_4_3_10_7_Mthr_2.txt;20;4;3;600.006;1;210;206;4;4;0;1;1;0
jobBased.exe;T17_medium;medium;instance_20_4_3_10_7_Mthr_3.txt;20;4;3;600.005;1;561;556;5;5;0;1;1;0
jobBased.exe;T17_medium;medium;instance_20_4_3_10_7_Mthr_4.txt;20;4;3;600.006;1;268;266;2;2;1;1;1;0
jobBased.exe;T17_medium;medium;instance_20_4_3_10_7_Mthr_5.txt;20;4;3;600.006;1;407;407;0;0;1;1;1;0
jobBased.exe;T17_medium;medium;instance_20_4_3_10_7_Mthr_6.txt;20;4;3;600.006;1;267;267;0;0;1;1;1;0
jobBased.exe;T17_medium;medium;instance_20_4_3_10_7_Mthr_7.txt;20;4;3;600.005;1;328;326;2;2;2;1;1;0
jobBased.exe;T17_medium;medium;instance_20_4_3_10_7_Mthr_8.txt;20;4;3;600.006;1;388;388;0;0;1;1;1;0
jobBased.exe;T17_medium;medium;instance_20_4_3_10_7_Mthr_9.txt;20;4;3;600.006;1;426;423;3;3;1;1;1;0
jobBased.exe;T17_small;small;instance_20_4_3_10_7_Sthr_0.txt;20;4;3;600.006;1;255;250;5;5;2;1;1;0
jobBased.exe;T17_small;small;instance_20_4_3_10_7_Sthr_1.txt;20;4;3;600.005;1;380;377;3;3;3;1;1;0
jobBased.exe;T17_small;small;instance_20_4_3_10_7_Sthr_2.txt;20;4;3;600.007;1;255;250;5;5;2;1;1;0
jobBased.exe;T17_small;small;instance_20_4_3_10_7_Sthr_3.txt;20;4;3;600.005;1;686;680;6;6;0;1;1;0
jobBased.exe;T17_small;small;instance_20_4_3_10_7_Sthr_4.txt;20;4;3;600.006;1;176;176;0;0;1;1;1;0
jobBased.exe;T17_small;small;instance_20_4_3_10_7_Sthr_5.txt;20;4;3;600.005;1;399;393;6;6;2;1;1;0
jobBased.exe;T17_small;small;instance_20_4_3_10_7_Sthr_6.txt;20;4;3;600.005;1;450;449;1;1;2;1;1;0
jobBased.exe;T17_small;small;instance_20_4_3_10_7_Sthr_7.txt;20;4;3;600.006;1;283;280;3;3;2;1;1;0
jobBased.exe;T17_small;small;instance_20_4_3_10_7_Sthr_8.txt;20;4;3;600.005;1;458;452;6;6;1;1;1;0
jobBased.exe;T17_small;small;instance_20_4_3_10_7_Sthr_9.txt;20;4;3;600.005;1;409;407;2;2;3;1;1;0
jobBased.exe;T18_big;big;instance_20_4_4_10_11_Bthr_0.txt;20;4;4;600.006;1;268;268;0;0;3;1;1;0
jobBased.exe;T18_big;big;instance_20_4_4_10_11_Bthr_1.txt;20;4;4;600.006;1;525;524;1;1;3;1;1;0
jobBased.exe;T18_big;big;instance_20_4_4_10_11_Bthr_2.txt;20;4;4;600.005;1;295;295;0;0;3;1;1;0
jobBased.exe;T18_big;big;instance_20_4_4_10_11_Bthr_3.txt;20;4;4;600.006;1;474;474;0;0;4;1;1;0
jobBased.exe;T18_big;big;instance_20_4_4_10_11_Bthr_4.txt;20;4;4;600.006;1;163;163;0;0;5;1;1;0
jobBased.exe;T18_big;big;instance_20_4_4_10_11_Bthr_5.txt;20;4;4;600.005;1;440;430;10;10;2;1;1;0
jobBased.exe;T18_big;big;instance_20_4_4_10_11_Bthr_6.txt;20;4;4;600.005;1;363;363;0;0;4;1;1;0
jobBased.exe;T18_big;big;instance_20_4_4_10_11_Bthr_7.txt;20;4;4;600.006;1;310;310;0;0;4;1;1;0
jobBased.exe;T18_big;big;instance_20_4_4_10_11_Bthr_8.txt;20;4;4;600.006;1;152;152;0;0;4;1;1;0
jobBased.exe;T18_big;big;instance_20_4_4_10_11_Bthr_9.txt;20;4;4;600.006;1;301;301;0;0;4;1;1;0
jobBased.exe;T18_medium;medium;instance_20_4_4_10_11_Mthr_0.txt;20;4;4;600.006;1;227;227;0;0;4;1;1;0
jobBased.exe;T18_medium;medium;instance_20_4_4_10_11_Mthr_1.txt;20;4;4;600.005;1;238;238;0;0;4;1;1;0
jobBased.exe;T18_medium;medium;instance_20_4_4_10_11_Mthr_2.txt;20;4;4;600.006;1;262;262;0;0;5;1;1;0
jobBased.exe;T18_medium;medium;instance_20_4_4_10_11_Mthr_3.txt;20;4;4;600.006;1;245;244;1;1;6;1;1;0
jobBased.exe;T18_medium;medium;instance_20_4_4_10_11_Mthr_4.txt;20;4;4;600.005;1;430;422;8;8;3;1;1;0
jobBased.exe;T18_medium;medium;instance_20_4_4_10_11_Mthr_5.txt;20;4;4;600.006;1;433;427;6;6;2;1;1;0
jobBased.exe;T18_medium;medium;instance_20_4_4_10_11_Mthr_6.txt;20;4;4;600.006;1;240;237;3;3;3;1;1;0
jobBased.exe;T18_medium;medium;instance_20_4_4_10_11_Mthr_7.txt;20;4;4;600.007;1;455;453;2;2;1;1;1;0
jobBased.exe;T18_medium;medium;instance_20_4_4_10_11_Mthr_8.txt;20;4;4;600.005;1;260;260;0;0;5;1;1;0
jobBased.exe;T18_medium;medium;instance_20_4_4_10_11_Mthr_9.txt;20;4;4;600.006;1;169;169;0;0;5;1;1;0
jobBased.exe;T18_small;small;instance_20_4_4_10_11_Sthr_0.txt;20;4;4;600.006;1;358;352;6;6;4;1;1;0
jobBased.exe;T18_small;small;instance_20_4_4_10_11_Sthr_1.txt;20;4;4;600.006;1;384;380;4;4;4;1;1;0
jobBased.exe;T18_small;small;instance_20_4_4_10_11_Sthr_2.txt;20;4;4;600.006;1;365;359;6;6;5;1;1;0
jobBased.exe;T18_small;small;instance_20_4_4_10_11_Sthr_3.txt;20;4;4;600.006;1;232;226;6;6;4;1;1;0
jobBased.exe;T18_small;small;instance_20_4_4_10_11_Sthr_4.txt;20;4;4;600.006;1;460;453;7;7;3;1;1;0
jobBased.exe;T18_small;small;instance_20_4_4_10_11_Sthr_5.txt;20;4;4;600.005;1;229;226;3;3;6;1;1;0
jobBased.exe;T18_small;small;instance_20_4_4_10_11_Sthr_6.txt;20;4;4;600.006;1;334;330;4;4;5;1;1;0
jobBased.exe;T18_small;small;instance_20_4_4_10_11_Sthr_7.txt;20;4;4;600.005;1;397;390;7;7;3;1;1;0
jobBased.exe;T18_small;small;instance_20_4_4_10_11_Sthr_8.txt;20;4;4;600.006;1;327;324;3;3;2;1;1;0
jobBased.exe;T18_small;small;instance_20_4_4_10_11_Sthr_9.txt;20;4;4;600.006;1;187;180;7;7;4;1;1;0
jobBased.exe;T19_big;big;instance_20_4_5_10_13_Bthr_0.txt;20;4;5;600.005;1;212;212;0;0;4;1;1;0
jobBased.exe;T19_big;big;instance_20_4_5_10_13_Bthr_1.txt;20;4;5;600.007;1;244;244;0;0;4;1;1;0
jobBased.exe;T19_big;big;instance_20_4_5_10_13_Bthr_2.txt;20;4;5;600.005;1;229;229;0;0;4;1;1;0
jobBased.exe;T19_big;big;instance_20_4_5_10_13_Bthr_3.txt;20;4;5;600.006;1;120;120;0;0;3;1;1;0
jobBased.exe;T19_big;big;instance_20_4_5_10_13_Bthr_4.txt;20;4;5;600.006;1;291;291;0;0;4;1;1;0
jobBased.exe;T19_big;big;instance_20_4_5_10_13_Bthr_5.txt;20;4;5;600.007;1;484;484;0;0;4;1;1;0
jobBased.exe;T19_big;big;instance_20_4_5_10_13_Bthr_6.txt;20;4;5;600.007;1;181;181;0;0;3;1;1;0
jobBased.exe;T19_big;big;instance_20_4_5_10_13_Bthr_7.txt;20;4;5;600.005;1;462;451;11;11;2;1;1;0
jobBased.exe;T19_big;big;instance_20_4_5_10_13_Bthr_8.txt;20;4;5;600.006;1;118;118;0;0;5;1;1;0
jobBased.exe;T19_big;big;instance_20_4_5_10_13_Bthr_9.txt;20;4;5;600.006;1;143;143;0;0;6;1;1;0
jobBased.exe;T19_medium;medium;instance_20_4_5_10_13_Mthr_0.txt;20;4;5;600.006;1;265;265;0;0;4;1;1;0
jobBased.exe;T19_medium;medium;instance_20_4_5_10_13_Mthr_1.txt;20;4;5;600.006;1;170;170;0;0;4;1;1;0
jobBased.exe;T19_medium;medium;instance_20_4_5_10_13_Mthr_2.txt;20;4;5;600.006;1;249;240;9;9;3;1;1;0
jobBased.exe;T19_medium;medium;instance_20_4_5_10_13_Mthr_3.txt;20;4;5;600.006;1;229;227;2;2;4;1;1;0
jobBased.exe;T19_medium;medium;instance_20_4_5_10_13_Mthr_4.txt;20;4;5;600.006;1;225;225;0;0;2;1;1;0
jobBased.exe;T19_medium;medium;instance_20_4_5_10_13_Mthr_5.txt;20;4;5;600.006;1;394;391;3;3;5;1;1;0
jobBased.exe;T19_medium;medium;instance_20_4_5_10_13_Mthr_6.txt;20;4;5;600.005;1;297;297;0;0;4;1;1;0
jobBased.exe;T19_medium;medium;instance_20_4_5_10_13_Mthr_7.txt;20;4;5;600.006;1;311;310;1;1;4;1;1;0
jobBased.exe;T19_medium;medium;instance_20_4_5_10_13_Mthr_8.txt;20;4;5;600.007;1;368;362;6;6;4;1;1;0
jobBased.exe;T19_medium;medium;instance_20_4_5_10_13_Mthr_9.txt;20;4;5;600.006;1;230;226;4;4;4;1;1;0
jobBased.exe;T19_small;small;instance_20_4_5_10_13_Sthr_0.txt;20;4;5;600.006;1;336;330;6;6;4;1;1;0
jobBased.exe;T19_small;small;instance_20_4_5_10_13_Sthr_1.txt;20;4;5;600.007;1;288;281;7;7;5;1;1;0
jobBased.exe;T19_small;small;instance_20_4_5_10_13_Sthr_2.txt;20;4;5;600.006;1;246;240;6;6;8;1;1;0
jobBased.exe;T19_small;small;instance_20_4_5_10_13_Sthr_3.txt;20;4;5;600.006;1;256;254;2;2;4;1;1;0
jobBased.exe;T19_small;small;instance_20_4_5_10_13_Sthr_4.txt;20;4;5;600.008;1;224;221;3;3;5;1;1;0
jobBased.exe;T19_small;small;instance_20_4_5_10_13_Sthr_5.txt;20;4;5;600.007;1;351;344;7;7;2;1;1;0
jobBased.exe;T19_small;small;instance_20_4_5_10_13_Sthr_6.txt;20;4;5;600.006;1;300;293;7;7;5;1;1;0
jobBased.exe;T19_small;small;instance_20_4_5_10_13_Sthr_7.txt;20;4;5;600.006;1;447;438;9;9;4;1;1;0
jobBased.exe;T19_small;small;instance_20_4_5_10_13_Sthr_8.txt;20;4;5;600.006;1;391;382;9;9;3;1;1;0
jobBased.exe;T19_small;small;instance_20_4_5_10_13_Sthr_9.txt;20;4;5;600.006;1;124;124;0;0;3;1;1;0
jobBased.exe;T20_big;big;instance_30_3_2_10_4_Bthr_0.txt;30;3;2;600.006;1;1116;1115;1;1;1;1;1;0
jobBased.exe;T20_big;big;instance_30_3_2_10_4_Bthr_1.txt;30;3;2;600.006;1;816;813;3;3;0;1;1;0
jobBased.exe;T20_big;big;instance_30_3_2_10_4_Bthr_2.txt;30;3;2;600.006;1;651;650;1;1;1;1;1;0
jobBased.exe;T20_big;big;instance_30_3_2_10_4_Bthr_3.txt;30;3;2;600.006;1;922;920;2;2;1;1;1;0
jobBased.exe;T20_big;big;instance_30_3_2_10_4_Bthr_4.txt;30;3;2;600.006;1;682;680;2;2;1;1;1;0
jobBased.exe;T20_big;big;instance_30_3_2_10_4_Bthr_5.txt;30;3;2;600.005;1;1242;1239;3;3;0;1;1;0
jobBased.exe;T20_big;big;instance_30_3_2_10_4_Bthr_6.txt;30;3;2;600.006;1;491;488;3;3;0;1;1;0
jobBased.exe;T20_big;big;instance_30_3_2_10_4_Bthr_7.txt;30;3;2;600.006;1;1323;1320;3;3;0;1;1;0
jobBased.exe;T20_big;big;instance_30_3_2_10_4_Bthr_8.txt;30;3;2;600.005;1;1323;1320;3;3;0;1;1;0
jobBased.exe;T20_big;big;instance_30_3_2_10_4_Bthr_9.txt;30;3;2;600.008;1;571;571;0;0;1;1;1;0
jobBased.exe;T20_medium;medium;instance_30_3_2_10_4_Mthr_0.txt;30;3;2;600.005;1;601;600;1;1;0;1;1;0
jobBased.exe;T20_medium;medium;instance_30_3_2_10_4_Mthr_1.txt;30;3;2;600.006;1;1241;1240;1;1;1;1;1;0
jobBased.exe;T20_medium;medium;instance_30_3_2_10_4_Mthr_2.txt;30;3;2;600.008;1;673;672;1;1;1;1;1;0
jobBased.exe;T20_medium;medium;instance_30_3_2_10_4_Mthr_3.txt;30;3;2;600.005;1;553;552;1;1;1;1;1;0
jobBased.exe;T20_medium;medium;instance_30_3_2_10_4_Mthr_4.txt;30;3;2;600.006;1;779;778;1;1;1;1;1;0
jobBased.exe;T20_medium;medium;instance_30_3_2_10_4_Mthr_5.txt;30;3;2;600.006;1;1170;1170;0;0;2;1;1;0
jobBased.exe;T20_medium;medium;instance_30_3_2_10_4_Mthr_6.txt;30;3;2;600.006;1;370;370;0;0;1;1;1;0
jobBased.exe;T20_medium;medium;instance_30_3_2_10_4_Mthr_7.txt;30;3;2;600.007;1;1323;1320;3;3;0;1;1;0
jobBased.exe;T20_medium;medium;instance_30_3_2_10_4_Mthr_8.txt;30;3;2;600.006;1;1251;1250;1;1;1;1;1;0
jobBased.exe;T20_medium;medium;instance_30_3_2_10_4_Mthr_9.txt;30;3;2;600.006;1;744;742;2;2;1;1;1;0
jobBased.exe;T20_small;small;instance_30_3_2_10_4_Sthr_0.txt;30;3;2;600.006;1;991;990;1;1;1;1;1;0
jobBased.exe;T20_small;small;instance_30_3_2_10_4_Sthr_1.txt;30;3;2;600.006;1;1587;1584;3;3;0;1;1;0
jobBased.exe;T20_small;small;instance_30_3_2_10_4_Sthr_2.txt;30;3;2;600.008;1;1259;1258;1;1;1;1;1;0
jobBased.exe;T20_small;small;instance_30_3_2_10_4_Sthr_3.txt;30;3;2;600.005;1;1720;1717;3;3;0;1;1;0
jobBased.exe;T20_small;small;instance_30_3_2_10_4_Sthr_4.txt;30;3;2;600.006;1;900;898;2;2;0;1;1;0
jobBased.exe;T20_small;small;instance_30_3_2_10_4_Sthr_5.txt;30;3;2;600.006;1;487;487;0;0;3;1;1;0
jobBased.exe;T20_small;small;instance_30_3_2_10_4_Sthr_6.txt;30;3;2;600.005;1;425;423;2;2;1;1;1;0
jobBased.exe;T20_small;small;instance_30_3_2_10_4_Sthr_7.txt;30;3;2;600.007;1;538;536;2;2;1;1;1;0
jobBased.exe;T20_small;small;instance_30_3_2_10_4_Sthr_8.txt;30;3;2;600.006;1;513;510;3;3;0;1;1;0
jobBased.exe;T20_small;small;instance_30_3_2_10_4_Sthr_9.txt;30;3;2;600.006;1;610;607;3;3;0;1;1;0
jobBased.exe;T21_big;big;instance_30_3_3_10_7_Bthr_0.txt;30;3;3;600.005;1;1508;1502;6;6;2;1;1;0
jobBased.exe;T21_big;big;instance_30_3_3_10_7_Bthr_1.txt;30;3;3;600.005;1;1177;1172;5;5;0;1;1;0
jobBased.exe;T21_big;big;instance_30_3_3_10_7_Bthr_2.txt;30;3;3;600.006;1;861;855;6;6;2;1;1;0
jobBased.exe;T21_big;big;instance_30_3_3_10_7_Bthr_3.txt;30;3;3;600.006;1;1184;1181;3;3;4;1;1;0
jobBased.exe;T21_big;big;instance_30_3_3_10_7_Bthr_4.txt;30;3;3;600.006;1;872;871;1;1;4;1;1;0
jobBased.exe;T21_big;big;instance_30_3_3_10_7_Bthr_5.txt;30;3;3;600.007;1;1092;1091;1;1;4;1;1;0
jobBased.exe;T21_big;big;instance_30_3_3_10_7_Bthr_6.txt;30;3;3;600.006;1;520;515;5;5;3;1;1;0
jobBased.exe;T21_big;big;instance_30_3_3_10_7_Bthr_7.txt;30;3;3;600.007;1;851;845;6;6;2;1;1;0
jobBased.exe;T21_big;big;instance_30_3_3_10_7_Bthr_8.txt;30;3;3;600.005;1;846;844;2;2;4;1;1;0
jobBased.exe;T21_big;big;instance_30_3_3_10_7_Bthr_9.txt;30;3;3;600.006;1;950;947;3;3;1;1;1;0
jobBased.exe;T21_medium;medium;instance_30_3_3_10_7_Mthr_0.txt;30;3;3;600.006;1;842;839;3;3;4;1;1;0
jobBased.exe;T21_medium;medium;instance_30_3_3_10_7_Mthr_1.txt;30;3;3;600.006;1;519;515;4;4;3;1;1;0
jobBased.exe;T21_medium;medium;instance_30_3_3_10_7_Mthr_2.txt;30;3;3;600.006;1;888;884;4;4;1;1;1;0
jobBased.exe;T21_medium;medium;instance_30_3_3_10_7_Mthr_3.txt;30;3;3;600.006;1;1208;1204;4;4;3;1;1;0
jobBased.exe;T21_medium;medium;instance_30_3_3_10_7_Mthr_4.txt;30;3;3;600.005;1;837;836;1;1;4;1;1;0
jobBased.exe;T21_medium;medium;instance_30_3_3_10_7_Mthr_5.txt;30;3;3;600.007;1;648;644;4;4;2;1;1;0
jobBased.exe;T21_medium;medium;instance_30_3_3_10_7_Mthr_6.txt;30;3;3;600.008;1;983;980;3;3;6;1;1;0
jobBased.exe;T21_medium;medium;instance_30_3_3_10_7_Mthr_7.txt;30;3;3;600.006;1;1249;1244;5;5;2;1;1;0
jobBased.exe;T21_medium;medium;instance_30_3_3_10_7_Mthr_8.txt;30;3;3;600.005;1;1268;1263;5;5;2;1;1;0
jobBased.exe;T21_medium;medium;instance_30_3_3_10_7_Mthr_9.txt;30;3;3;600.005;1;1519;1513;6;6;1;1;1;0
jobBased.exe;T21_small;small;instance_30_3_3_10_7_Sthr_0.txt;30;3;3;600.006;1;1162;1157;5;5;3;1;1;0
jobBased.exe;T21_small;small;instance_30_3_3_10_7_Sthr_1.txt;30;3;3;600.006;1;528;524;4;4;4;1;1;0
jobBased.exe;T21_small;small;instance_30_3_3_10_7_Sthr_2.txt;30;3;3;600.007;1;1514;1510;4;4;3;1;1;0
jobBased.exe;T21_small;small;instance_30_3_3_10_7_Sthr_3.txt;30;3;3;600.007;1;716;712;4;4;4;1;1;0
jobBased.exe;T21_small;small;instance_30_3_3_10_7_Sthr_4.txt;30;3;3;600.006;1;333;330;3;3;3;1;1;0
jobBased.exe;T21_small;small;instance_30_3_3_10_7_Sthr_5.txt;30;3;3;600.006;1;643;639;4;4;2;1;1;0
jobBased.exe;T21_small;small;instance_30_3_3_10_7_Sthr_6.txt;30;3;3;600.007;1;1165;1161;4;4;3;1;1;0
jobBased.exe;T21_small;small;instance_30_3_3_10_7_Sthr_7.txt;30;3;3;600.006;1;1159;1155;4;4;5;1;1;0
jobBased.exe;T21_small;small;instance_30_3_3_10_7_Sthr_8.txt;30;3;3;600.007;1;985;981;4;4;4;1;1;0
jobBased.exe;T21_small;small;instance_30_3_3_10_7_Sthr_9.txt;30;3;3;600.008;1;1003;999;4;4;4;1;1;0
jobBased.exe;T22_big;big;instance_30_3_4_10_8_Bthr_0.txt;30;3;4;600.004;1;825;821;4;4;3;1;1;0
jobBased.exe;T22_big;big;instance_30_3_4_10_8_Bthr_1.txt;30;3;4;600.006;1;282;282;0;0;4;1;1;0
jobBased.exe;T22_big;big;instance_30_3_4_10_8_Bthr_2.txt;30;3;4;600.005;1;552;551;1;1;5;1;1;0
jobBased.exe;T22_big;big;instance_30_3_4_10_8_Bthr_3.txt;30;3;4;600.005;1;749;745;4;4;5;1;1;0
jobBased.exe;T22_big;big;instance_30_3_4_10_8_Bthr_4.txt;30;3;4;600.005;1;854;849;5;5;3;1;1;0
jobBased.exe;T22_big;big;instance_30_3_4_10_8_Bthr_5.txt;30;3;4;600.005;1;1032;1031;1;1;5;1;1;0
jobBased.exe;T22_big;big;instance_30_3_4_10_8_Bthr_6.txt;30;3;4;600.005;1;877;872;5;5;2;1;1;0
jobBased.exe;T22_big;big;instance_30_3_4_10_8_Bthr_7.txt;30;3;4;600.005;1;869;862;7;7;2;1;1;0
jobBased.exe;T22_big;big;instance_30_3_4_10_8_Bthr_8.txt;30;3;4;600.006;1;1123;1120;3;3;4;1;1;0
jobBased.exe;T22_big;big;instance_30_3_4_10_8_Bthr_9.txt;30;3;4;600.005;1;627;622;5;5;1;1;1;0
jobBased.exe;T22_medium;medium;instance_30_3_4_10_8_Mthr_0.txt;30;3;4;600.006;1;488;484;4;4;4;1;1;0
jobBased.exe;T22_medium;medium;instance_30_3_4_10_8_Mthr_1.txt;30;3;4;600.005;1;1392;1388;4;4;3;1;1;0
jobBased.exe;T22_medium;medium;instance_30_3_4_10_8_Mthr_2.txt;30;3;4;600.005;1;462;456;6;6;2;1;1;0
jobBased.exe;T22_medium;medium;instance_30_3_4_10_8_Mthr_3.txt;30;3;4;600.005;1;801;797;4;4;2;1;1;0
jobBased.exe;T22_medium;medium;instance_30_3_4_10_8_Mthr_4.txt;30;3;4;600.005;1;898;893;5;5;4;1;1;0
jobBased.exe;T22_medium;medium;instance_30_3_4_10_8_Mthr_5.txt;30;3;4;600.006;1;1211;1205;6;6;2;1;1;0
jobBased.exe;T22_medium;medium;instance_30_3_4_10_8_Mthr_6.txt;30;3;4;600.005;1;763;758;5;5;4;1;1;0
jobBased.exe;T22_medium;medium;instance_30_3_4_10_8_Mthr_7.txt;30;3;4;600.005;1;566;564;2;2;4;1;1;0
jobBased.exe;T22_medium;medium;instance_30_3_4_10_8_Mthr_8.txt;30;3;4;600.006;1;793;788;5;5;2;1;1;0
jobBased.exe;T22_medium;medium;instance_30_3_4_10_8_Mthr_9.txt;30;3;4;600.007;1;676;673;3;3;6;1;1;0
jobBased.exe;T22_small;small;instance_30_3_4_10_8_Sthr_0.txt;30;3;4;600.006;1;902;895;7;7;3;1;1;0
jobBased.exe;T22_small;small;instance_30_3_4_10_8_Sthr_1.txt;30;3;4;600.005;1;1040;1033;7;7;4;1;1;0
jobBased.exe;T22_small;small;instance_30_3_4_10_8_Sthr_2.txt;30;3;4;600.005;1;878;874;4;4;5;1;1;0
jobBased.exe;T22_small;small;instance_30_3_4_10_8_Sthr_3.txt;30;3;4;600.007;1;1123;1118;5;5;7;1;1;0
jobBased.exe;T22_small;small;instance_30_3_4_10_8_Sthr_4.txt;30;3;4;600.005;1;1090;1085;5;5;4;1;1;0
jobBased.exe;T22_small;small;instance_30_3_4_10_8_Sthr_5.txt;30;3;4;600.005;1;458;453;5;5;4;1;1;0
jobBased.exe;T22_small;small;instance_30_3_4_10_8_Sthr_6.txt;30;3;4;600.006;1;707;702;5;5;6;1;1;0
jobBased.exe;T22_small;small;instance_30_3_4_10_8_Sthr_7.txt;30;3;4;600.005;1;748;741;7;7;3;1;1;0
jobBased.exe;T22_small;small;instance_30_3_4_10_8_Sthr_8.txt;30;3;4;600.006;1;629;623;6;6;4;1;1;0
jobBased.exe;T22_small;small;instance_30_3_4_10_8_Sthr_9.txt;30;3;4;600.006;1;1340;1334;6;6;6;1;1;0
jobBased.exe;T23_big;big;instance_30_3_5_10_13_Bthr_0.txt;30;3;5;600.006;1;750;744;6;6;8;1;1;0
jobBased.exe;T23_big;big;instance_30_3_5_10_13_Bthr_1.txt;30;3;5;600.009;1;450;450;0;0;6;1;1;0
jobBased.exe;T23_big;big;instance_30_3_5_10_13_Bthr_2.txt;30;3;5;600.006;1;993;988;5;5;7;1;1;0
jobBased.exe;T23_big;big;instance_30_3_5_10_13_Bthr_3.txt;30;3;5;600.006;1;763;758;5;5;9;1;1;0
jobBased.exe;T23_big;big;instance_30_3_5_10_13_Bthr_4.txt;30;3;5;600.006;1;657;655;2;2;9;1;1;0
jobBased.exe;T23_big;big;instance_30_3_5_10_13_Bthr_5.txt;30;3;5;600.006;1;666;656;10;10;5;1;1;0
jobBased.exe;T23_big;big;instance_30_3_5_10_13_Bthr_6.txt;30;3;5;600.006;1;567;563;4;4;7;1;1;0
jobBased.exe;T23_big;big;instance_30_3_5_10_13_Bthr_7.txt;30;3;5;600.006;1;794;789;5;5;6;1;1;0
jobBased.exe;T23_big;big;instance_30_3_5_10_13_Bthr_8.txt;30;3;5;600.007;1;749;745;4;4;9;1;1;0
jobBased.exe;T23_big;big;instance_30_3_5_10_13_Bthr_9.txt;30;3;5;600.007;1;376;370;6;6;6;1;1;0
jobBased.exe;T23_medium;medium;instance_30_3_5_10_13_Mthr_0.txt;30;3;5;600.006;1;755;748;7;7;7;1;1;0
jobBased.exe;T23_medium;medium;instance_30_3_5_10_13_Mthr_1.txt;30;3;5;600.008;1;399;389;10;10;4;1;1;0
jobBased.exe;T23_medium;medium;instance_30_3_5_10_13_Mthr_2.txt;30;3;5;600;0; ; ; ; ; ; ; 
jobBased.exe;T23_medium;medium;instance_30_3_5_10_13_Mthr_3.txt;30;3;5;600.006;1;676;668;8;8;7;1;1;0
jobBased.exe;T23_medium;medium;instance_30_3_5_10_13_Mthr_4.txt;30;3;5;600;0; ; ; ; ; ; ; 
jobBased.exe;T23_medium;medium;instance_30_3_5_10_13_Mthr_5.txt;30;3;5;600.007;1;539;533;6;6;6;1;1;0
jobBased.exe;T23_medium;medium;instance_30_3_5_10_13_Mthr_6.txt;30;3;5;600;0; ; ; ; ; ; ; 
jobBased.exe;T23_medium;medium;instance_30_3_5_10_13_Mthr_7.txt;30;3;5;600;0; ; ; ; ; ; ; 
jobBased.exe;T23_medium;medium;instance_30_3_5_10_13_Mthr_8.txt;30;3;5;600.004;1;1102;1093;9;9;6;1;1;0
jobBased.exe;T23_medium;medium;instance_30_3_5_10_13_Mthr_9.txt;30;3;5;600.006;1;688;678;10;10;3;1;1;0
jobBased.exe;T23_small;small;instance_30_3_5_10_13_Sthr_0.txt;30;3;5;600;0; ; ; ; ; ; ; 
jobBased.exe;T23_small;small;instance_30_3_5_10_13_Sthr_1.txt;30;3;5;600.007;1;1212;1202;10;10;2;1;1;0
jobBased.exe;T23_small;small;instance_30_3_5_10_13_Sthr_2.txt;30;3;5;600.004;1;1141;1130;11;11;4;1;1;0
jobBased.exe;T23_small;small;instance_30_3_5_10_13_Sthr_3.txt;30;3;5;600.004;1;973;963;10;10;8;1;1;0
jobBased.exe;T23_small;small;instance_30_3_5_10_13_Sthr_4.txt;30;3;5;600.005;1;599;590;9;9;6;1;1;0
jobBased.exe;T23_small;small;instance_30_3_5_10_13_Sthr_5.txt;30;3;5;600.006;1;686;676;10;10;6;1;1;0
jobBased.exe;T23_small;small;instance_30_3_5_10_13_Sthr_6.txt;30;3;5;600.007;1;767;758;9;9;5;1;1;0
jobBased.exe;T23_small;small;instance_30_3_5_10_13_Sthr_7.txt;30;3;5;600.004;1;791;784;7;5;21;1;1;0
jobBased.exe;T23_small;small;instance_30_3_5_10_13_Sthr_8.txt;30;3;5;600.006;1;516;506;10;10;3;1;1;0
jobBased.exe;T23_small;small;instance_30_3_5_10_13_Sthr_9.txt;30;3;5;600.005;1;304;294;10;10;4;1;1;0
jobBased.exe;T24_big;big;instance_30_4_4_10_10_Bthr_0.txt;30;4;4;600.009;1;237;237;0;0;2;1;1;0
jobBased.exe;T24_big;big;instance_30_4_4_10_10_Bthr_1.txt;30;4;4;600.006;1;522;516;6;6;1;1;1;0
jobBased.exe;T24_big;big;instance_30_4_4_10_10_Bthr_2.txt;30;4;4;600.006;1;574;574;0;0;2;1;1;0
jobBased.exe;T24_big;big;instance_30_4_4_10_10_Bthr_3.txt;30;4;4;600.006;1;284;284;0;0;4;1;1;0
jobBased.exe;T24_big;big;instance_30_4_4_10_10_Bthr_4.txt;30;4;4;600.006;1;489;483;6;6;2;1;1;0
jobBased.exe;T24_big;big;instance_30_4_4_10_10_Bthr_5.txt;30;4;4;600.007;1;685;683;2;2;4;1;1;0
jobBased.exe;T24_big;big;instance_30_4_4_10_10_Bthr_6.txt;30;4;4;600.006;1;729;727;2;2;4;1;1;0
jobBased.exe;T24_big;big;instance_30_4_4_10_10_Bthr_7.txt;30;4;4;600.007;1;812;808;4;4;4;1;1;0
jobBased.exe;T24_big;big;instance_30_4_4_10_10_Bthr_8.txt;30;4;4;600.006;1;641;640;1;1;5;1;1;0
jobBased.exe;T24_big;big;instance_30_4_4_10_10_Bthr_9.txt;30;4;4;600.007;1;839;833;6;6;2;1;1;0
jobBased.exe;T24_medium;medium;instance_30_4_4_10_10_Mthr_0.txt;30;4;4;600.007;1;626;624;2;2;4;1;1;0
jobBased.exe;T24_medium;medium;instance_30_4_4_10_10_Mthr_1.txt;30;4;4;600.005;1;885;880;5;5;4;1;1;0
jobBased.exe;T24_medium;medium;instance_30_4_4_10_10_Mthr_2.txt;30;4;4;600.007;1;502;496;6;6;3;1;1;0
jobBased.exe;T24_medium;medium;instance_30_4_4_10_10_Mthr_3.txt;30;4;4;600.006;1;1115;1110;5;5;3;1;1;0
jobBased.exe;T24_medium;medium;instance_30_4_4_10_10_Mthr_4.txt;30;4;4;600.006;1;564;558;6;6;2;1;1;0
jobBased.exe;T24_medium;medium;instance_30_4_4_10_10_Mthr_5.txt;30;4;4;600.006;1;429;425;4;4;5;1;1;0
jobBased.exe;T24_medium;medium;instance_30_4_4_10_10_Mthr_6.txt;30;4;4;600.006;1;633;628;5;5;6;1;1;0
jobBased.exe;T24_medium;medium;instance_30_4_4_10_10_Mthr_7.txt;30;4;4;600.006;1;741;735;6;6;2;1;1;0
jobBased.exe;T24_medium;medium;instance_30_4_4_10_10_Mthr_8.txt;30;4;4;600.007;1;1160;1154;6;6;4;1;1;0
jobBased.exe;T24_medium;medium;instance_30_4_4_10_10_Mthr_9.txt;30;4;4;600.006;1;373;372;1;1;6;1;1;0
jobBased.exe;T24_small;small;instance_30_4_4_10_10_Sthr_0.txt;30;4;4;600.007;1;635;629;6;6;4;1;1;0
jobBased.exe;T24_small;small;instance_30_4_4_10_10_Sthr_1.txt;30;4;4;600.006;1;764;759;5;5;3;1;1;0
jobBased.exe;T24_small;small;instance_30_4_4_10_10_Sthr_2.txt;30;4;4;600.006;1;481;474;7;7;3;1;1;0
jobBased.exe;T24_small;small;instance_30_4_4_10_10_Sthr_3.txt;30;4;4;600.007;1;619;610;9;9;0;1;1;0
jobBased.exe;T24_small;small;instance_30_4_4_10_10_Sthr_4.txt;30;4;4;600.007;1;421;415;6;6;2;1;1;0
jobBased.exe;T24_small;small;instance_30_4_4_10_10_Sthr_5.txt;30;4;4;600.007;1;391;384;7;7;2;1;1;0
jobBased.exe;T24_small;small;instance_30_4_4_10_10_Sthr_6.txt;30;4;4;600.008;1;897;892;5;5;5;1;1;0
jobBased.exe;T24_small;small;instance_30_4_4_10_10_Sthr_7.txt;30;4;4;600.006;1;488;482;6;6;4;1;1;0
jobBased.exe;T24_small;small;instance_30_4_4_10_10_Sthr_8.txt;30;4;4;600.005;1;901;894;7;7;1;1;1;0
jobBased.exe;T24_small;small;instance_30_4_4_10_10_Sthr_9.txt;30;4;4;600.005;1;742;736;6;6;2;1;1;0
jobBased.exe;T25_big;big;instance_30_5_5_10_14_Bthr_0.txt;30;5;5;600.007;1;388;388;0;0;5;1;1;0
jobBased.exe;T25_big;big;instance_30_5_5_10_14_Bthr_1.txt;30;5;5;600.007;1;391;391;0;0;4;1;1;0
jobBased.exe;T25_big;big;instance_30_5_5_10_14_Bthr_2.txt;30;5;5;600.007;1;736;736;0;0;2;1;1;0
jobBased.exe;T25_big;big;instance_30_5_5_10_14_Bthr_3.txt;30;5;5;600.009;1;486;486;0;0;4;1;1;0
jobBased.exe;T25_big;big;instance_30_5_5_10_14_Bthr_4.txt;30;5;5;600.008;1;646;646;0;0;3;1;1;0
jobBased.exe;T25_big;big;instance_30_5_5_10_14_Bthr_5.txt;30;5;5;600.005;1;916;903;13;13;2;1;1;0
jobBased.exe;T25_big;big;instance_30_5_5_10_14_Bthr_6.txt;30;5;5;600.006;1;333;333;0;0;5;1;1;0
jobBased.exe;T25_big;big;instance_30_5_5_10_14_Bthr_7.txt;30;5;5;600.007;1;533;533;0;0;4;1;1;0
jobBased.exe;T25_big;big;instance_30_5_5_10_14_Bthr_8.txt;30;5;5;600.007;1;496;496;0;0;6;1;1;0
jobBased.exe;T25_big;big;instance_30_5_5_10_14_Bthr_9.txt;30;5;5;600.006;1;573;573;0;0;5;1;1;0
jobBased.exe;T25_medium;medium;instance_30_5_5_10_14_Mthr_0.txt;30;5;5;600.007;1;440;437;3;3;8;1;1;0
jobBased.exe;T25_medium;medium;instance_30_5_5_10_14_Mthr_1.txt;30;5;5;600.005;1;706;695;11;11;4;1;1;0
jobBased.exe;T25_medium;medium;instance_30_5_5_10_14_Mthr_2.txt;30;5;5;600.007;1;375;364;11;11;5;1;1;0
jobBased.exe;T25_medium;medium;instance_30_5_5_10_14_Mthr_3.txt;30;5;5;600.008;1;553;547;6;6;3;1;1;0
jobBased.exe;T25_medium;medium;instance_30_5_5_10_14_Mthr_4.txt;30;5;5;600.005;1;738;728;10;10;2;1;1;0
jobBased.exe;T25_medium;medium;instance_30_5_5_10_14_Mthr_5.txt;30;5;5;600.007;1;482;479;3;3;4;1;1;0
jobBased.exe;T25_medium;medium;instance_30_5_5_10_14_Mthr_6.txt;30;5;5;600.007;1;539;531;8;8;3;1;1;0
jobBased.exe;T25_medium;medium;instance_30_5_5_10_14_Mthr_7.txt;30;5;5;600.006;1;576;568;8;8;5;1;1;0
jobBased.exe;T25_medium;medium;instance_30_5_5_10_14_Mthr_8.txt;30;5;5;600.007;1;354;354;0;0;6;1;1;0
jobBased.exe;T25_medium;medium;instance_30_5_5_10_14_Mthr_9.txt;30;5;5;600.007;1;646;640;6;6;4;1;1;0
jobBased.exe;T25_small;small;instance_30_5_5_10_14_Sthr_0.txt;30;5;5;600.007;1;455;447;8;8;6;1;1;0
jobBased.exe;T25_small;small;instance_30_5_5_10_14_Sthr_1.txt;30;5;5;600.006;1;505;496;9;9;3;1;1;0
jobBased.exe;T25_small;small;instance_30_5_5_10_14_Sthr_2.txt;30;5;5;600.006;1;412;403;9;9;3;1;1;0
jobBased.exe;T25_small;small;instance_30_5_5_10_14_Sthr_3.txt;30;5;5;600.006;1;580;571;9;9;2;1;1;0
jobBased.exe;T25_small;small;instance_30_5_5_10_14_Sthr_4.txt;30;5;5;600.009;1;495;486;9;9;5;1;1;0
jobBased.exe;T25_small;small;instance_30_5_5_10_14_Sthr_5.txt;30;5;5;600.005;1;664;652;12;12;3;1;1;0
jobBased.exe;T25_small;small;instance_30_5_5_10_14_Sthr_6.txt;30;5;5;600.006;1;395;387;8;8;5;1;1;0
jobBased.exe;T25_small;small;instance_30_5_5_10_14_Sthr_7.txt;30;5;5;600.007;1;699;693;6;6;8;1;1;0
jobBased.exe;T25_small;small;instance_30_5_5_10_14_Sthr_8.txt;30;5;5;600.008;1;505;497;8;8;7;1;1;0
jobBased.exe;T25_small;small;instance_30_5_5_10_14_Sthr_9.txt;30;5;5;600.006;1;505;492;13;13;5;1;1;0
jobBased.exe;T27_big;big;instance_40_3_3_10_5_Bthr_0.txt;40;3;3;600.007;1;1599;1596;3;3;0;1;1;0
jobBased.exe;T27_big;big;instance_40_3_3_10_5_Bthr_1.txt;40;3;3;600.006;1;990;987;3;3;2;1;1;0
jobBased.exe;T27_big;big;instance_40_3_3_10_5_Bthr_2.txt;40;3;3;600.006;1;2407;2405;2;2;2;1;1;0
jobBased.exe;T27_big;big;instance_40_3_3_10_5_Bthr_3.txt;40;3;3;600.006;1;1960;1958;2;2;2;1;1;0
jobBased.exe;T27_big;big;instance_40_3_3_10_5_Bthr_4.txt;40;3;3;600.006;1;1202;1200;2;2;2;1;1;0
jobBased.exe;T27_big;big;instance_40_3_3_10_5_Bthr_5.txt;40;3;3;600.007;1;1367;1365;2;2;2;1;1;0
jobBased.exe;T27_big;big;instance_40_3_3_10_5_Bthr_6.txt;40;3;3;600.006;1;781;777;4;4;2;1;1;0
jobBased.exe;T27_big;big;instance_40_3_3_10_5_Bthr_7.txt;40;3;3;600.007;1;894;892;2;2;2;1;1;0
jobBased.exe;T27_big;big;instance_40_3_3_10_5_Bthr_8.txt;40;3;3;600.005;1;1229;1226;3;3;2;1;1;0
jobBased.exe;T27_big;big;instance_40_3_3_10_5_Bthr_9.txt;40;3;3;600.006;1;1067;1065;2;2;1;1;1;0
jobBased.exe;T27_medium;medium;instance_40_3_3_10_5_Mthr_0.txt;40;3;3;600.007;1;859;855;4;4;0;1;1;0
jobBased.exe;T27_medium;medium;instance_40_3_3_10_5_Mthr_1.txt;40;3;3;600.006;1;1919;1917;2;2;3;1;1;0
jobBased.exe;T27_medium;medium;instance_40_3_3_10_5_Mthr_2.txt;40;3;3;600.006;1;1293;1290;3;3;4;1;1;0
jobBased.exe;T27_medium;medium;instance_40_3_3_10_5_Mthr_3.txt;40;3;3;600.006;1;1885;1881;4;4;0;1;1;0
jobBased.exe;T27_medium;medium;instance_40_3_3_10_5_Mthr_4.txt;40;3;3;600.006;1;1336;1332;4;4;0;1;1;0
jobBased.exe;T27_medium;medium;instance_40_3_3_10_5_Mthr_5.txt;40;3;3;600.005;1;2213;2210;3;3;1;1;1;0
jobBased.exe;T27_medium;medium;instance_40_3_3_10_5_Mthr_6.txt;40;3;3;600.008;1;1589;1587;2;2;3;1;1;0
jobBased.exe;T27_medium;medium;instance_40_3_3_10_5_Mthr_7.txt;40;3;3;600.007;1;598;596;2;2;2;1;1;0
jobBased.exe;T27_medium;medium;instance_40_3_3_10_5_Mthr_8.txt;40;3;3;600.006;1;860;856;4;4;0;1;1;0
jobBased.exe;T27_medium;medium;instance_40_3_3_10_5_Mthr_9.txt;40;3;3;600.005;1;2499;2497;2;2;0;1;1;0
jobBased.exe;T27_small;small;instance_40_3_3_10_5_Sthr_0.txt;40;3;3;600.006;1;856;855;1;1;6;1;1;0
jobBased.exe;T27_small;small;instance_40_3_3_10_5_Sthr_1.txt;40;3;3;600.006;1;1664;1660;4;4;0;1;1;0
jobBased.exe;T27_small;small;instance_40_3_3_10_5_Sthr_2.txt;40;3;3;600.007;1;1495;1493;2;2;4;1;1;0
jobBased.exe;T27_small;small;instance_40_3_3_10_5_Sthr_3.txt;40;3;3;600.006;1;2428;2424;4;4;3;1;1;0
jobBased.exe;T27_small;small;instance_40_3_3_10_5_Sthr_4.txt;40;3;3;600.007;1;2160;2157;3;3;1;1;1;0
jobBased.exe;T27_small;small;instance_40_3_3_10_5_Sthr_5.txt;40;3;3;600.006;1;1345;1341;4;4;0;1;1;0
jobBased.exe;T27_small;small;instance_40_3_3_10_5_Sthr_6.txt;40;3;3;600.006;1;2944;2940;4;4;3;1;1;0
jobBased.exe;T27_small;small;instance_40_3_3_10_5_Sthr_7.txt;40;3;3;600.005;1;1354;1352;2;2;1;1;1;0
jobBased.exe;T27_small;small;instance_40_3_3_10_5_Sthr_8.txt;40;3;3;600.007;1;1488;1485;3;3;1;1;1;0
jobBased.exe;T27_small;small;instance_40_3_3_10_5_Sthr_9.txt;40;3;3;600.005;1;1646;1643;3;3;0;1;1;0
jobBased.exe;T34_big;big;instance_50_3_3_10_6_Bthr_0.txt;50;3;3;600.007;1;1928;1924;4;4;3;1;1;0
jobBased.exe;T34_big;big;instance_50_3_3_10_6_Bthr_1.txt;50;3;3;600.009;1;2995;2991;4;4;1;1;1;0
jobBased.exe;T34_big;big;instance_50_3_3_10_6_Bthr_2.txt;50;3;3;600.009;1;2402;2399;3;3;2;1;1;0
jobBased.exe;T34_big;big;instance_50_3_3_10_6_Bthr_3.txt;50;3;3;600.009;1;2037;2032;5;5;1;1;1;0
jobBased.exe;T34_big;big;instance_50_3_3_10_6_Bthr_4.txt;50;3;3;600.008;1;1658;1655;3;3;2;1;1;0
jobBased.exe;T34_big;big;instance_50_3_3_10_6_Bthr_5.txt;50;3;3;600.008;1;2820;2818;2;2;3;1;1;0
jobBased.exe;T34_big;big;instance_50_3_3_10_6_Bthr_6.txt;50;3;3;600.008;1;1586;1581;5;5;0;1;1;0
jobBased.exe;T34_big;big;instance_50_3_3_10_6_Bthr_7.txt;50;3;3;600.008;1;1714;1711;3;3;4;1;1;0
jobBased.exe;T34_big;big;instance_50_3_3_10_6_Bthr_8.txt;50;3;3;600.01;1;1095;1093;2;2;2;1;1;0
jobBased.exe;T34_big;big;instance_50_3_3_10_6_Bthr_9.txt;50;3;3;600.008;1;3081;3077;4;4;0;1;1;0
jobBased.exe;T34_medium;medium;instance_50_3_3_10_6_Mthr_0.txt;50;3;3;600.011;1;3080;3078;2;2;4;1;1;0
jobBased.exe;T34_medium;medium;instance_50_3_3_10_6_Mthr_1.txt;50;3;3;600.008;1;2556;2552;4;4;0;1;1;0
jobBased.exe;T34_medium;medium;instance_50_3_3_10_6_Mthr_2.txt;50;3;3;600.007;1;1837;1832;5;5;1;1;1;0
jobBased.exe;T34_medium;medium;instance_50_3_3_10_6_Mthr_3.txt;50;3;3;600.008;1;1358;1353;5;5;0;1;1;0
jobBased.exe;T34_medium;medium;instance_50_3_3_10_6_Mthr_4.txt;50;3;3;600.01;1;3207;3204;3;3;1;1;1;0
jobBased.exe;T34_medium;medium;instance_50_3_3_10_6_Mthr_5.txt;50;3;3;600.008;1;1993;1990;3;3;6;1;1;0
jobBased.exe;T34_medium;medium;instance_50_3_3_10_6_Mthr_6.txt;50;3;3;600.008;1;3590;3586;4;4;1;1;1;0
jobBased.exe;T34_medium;medium;instance_50_3_3_10_6_Mthr_7.txt;50;3;3;600.01;1;1525;1521;4;4;3;1;1;0
jobBased.exe;T34_medium;medium;instance_50_3_3_10_6_Mthr_8.txt;50;3;3;600.009;1;2397;2394;3;3;3;1;1;0
jobBased.exe;T34_medium;medium;instance_50_3_3_10_6_Mthr_9.txt;50;3;3;600.008;1;1861;1858;3;3;2;1;1;0
jobBased.exe;T34_small;small;instance_50_3_3_10_6_Sthr_0.txt;50;3;3;600.008;1;2662;2658;4;4;0;1;1;0
jobBased.exe;T34_small;small;instance_50_3_3_10_6_Sthr_1.txt;50;3;3;600.009;1;3109;3106;3;3;7;1;1;0
jobBased.exe;T34_small;small;instance_50_3_3_10_6_Sthr_2.txt;50;3;3;600.007;1;1917;1912;5;5;0;1;1;0
jobBased.exe;T34_small;small;instance_50_3_3_10_6_Sthr_3.txt;50;3;3;600.008;1;1506;1501;5;5;3;1;1;0
jobBased.exe;T34_small;small;instance_50_3_3_10_6_Sthr_4.txt;50;3;3;600.009;1;1035;1030;5;5;3;1;1;0
jobBased.exe;T34_small;small;instance_50_3_3_10_6_Sthr_5.txt;50;3;3;600.009;1;1798;1794;4;4;5;1;1;0
jobBased.exe;T34_small;small;instance_50_3_3_10_6_Sthr_6.txt;50;3;3;600.008;1;1834;1829;5;5;0;1;1;0
jobBased.exe;T34_small;small;instance_50_3_3_10_6_Sthr_7.txt;50;3;3;600.009;1;2899;2895;4;4;0;1;1;0
jobBased.exe;T34_small;small;instance_50_3_3_10_6_Sthr_8.txt;50;3;3;600.009;1;1177;1172;5;5;2;1;1;0
jobBased.exe;T34_small;small;instance_50_3_3_10_6_Sthr_9.txt;50;3;3;600.008;1;1927;1922;5;5;1;1;1;0
jobBased.exe;T39_big;big;instance_60_3_4_10_9_Bthr_0.txt;60;3;4;600.015;1;1780;1773;7;7;5;1;1;0
jobBased.exe;T39_big;big;instance_60_3_4_10_9_Bthr_1.txt;60;3;4;600.011;1;4998;4991;7;7;2;1;1;0
jobBased.exe;T39_big;big;instance_60_3_4_10_9_Bthr_2.txt;60;3;4;600.01;1;4003;3997;6;6;5;1;1;0
jobBased.exe;T39_big;big;instance_60_3_4_10_9_Bthr_3.txt;60;3;4;600.009;1;4189;4182;7;7;2;1;1;0
jobBased.exe;T39_big;big;instance_60_3_4_10_9_Bthr_4.txt;60;3;4;600.01;1;3359;3353;6;6;7;1;1;0
jobBased.exe;T39_big;big;instance_60_3_4_10_9_Bthr_5.txt;60;3;4;600.014;1;1746;1741;5;5;7;1;1;0
jobBased.exe;T39_big;big;instance_60_3_4_10_9_Bthr_6.txt;60;3;4;600.011;1;4290;4283;7;7;5;1;1;0
jobBased.exe;T39_big;big;instance_60_3_4_10_9_Bthr_7.txt;60;3;4;600.009;1;2406;2400;6;6;6;1;1;0
jobBased.exe;T39_big;big;instance_60_3_4_10_9_Bthr_8.txt;60;3;4;600.011;1;2907;2903;4;4;12;1;1;0
jobBased.exe;T39_big;big;instance_60_3_4_10_9_Bthr_9.txt;60;3;4;600.013;1;4063;4059;4;4;11;1;1;0
jobBased.exe;T39_medium;medium;instance_60_3_4_10_9_Mthr_0.txt;60;3;4;600.012;1;3584;3577;7;7;3;1;1;0
jobBased.exe;T39_medium;medium;instance_60_3_4_10_9_Mthr_1.txt;60;3;4;600.01;1;3025;3019;6;6;6;1;1;0
jobBased.exe;T39_medium;medium;instance_60_3_4_10_9_Mthr_2.txt;60;3;4;600;0; ; ; ; ; ; ; 
jobBased.exe;T39_medium;medium;instance_60_3_4_10_9_Mthr_3.txt;60;3;4;600;0; ; ; ; ; ; ; 
jobBased.exe;T39_medium;medium;instance_60_3_4_10_9_Mthr_4.txt;60;3;4;600.013;1;2179;2174;5;5;12;1;1;0
jobBased.exe;T39_medium;medium;instance_60_3_4_10_9_Mthr_5.txt;60;3;4;600.012;1;2608;2602;6;6;9;1;1;0
jobBased.exe;T39_medium;medium;instance_60_3_4_10_9_Mthr_6.txt;60;3;4;600.013;1;1097;1091;6;6;5;1;1;0
jobBased.exe;T39_medium;medium;instance_60_3_4_10_9_Mthr_7.txt;60;3;4;600.012;1;1874;1867;7;7;3;1;1;0
jobBased.exe;T39_medium;medium;instance_60_3_4_10_9_Mthr_8.txt;60;3;4;600.011;1;3665;3657;8;8;3;1;1;0
jobBased.exe;T39_medium;medium;instance_60_3_4_10_9_Mthr_9.txt;60;3;4;600.01;1;1765;1759;6;6;4;1;1;0
jobBased.exe;T39_small;small;instance_60_3_4_10_9_Sthr_0.txt;60;3;4;600;0; ; ; ; ; ; ; 
jobBased.exe;T39_small;small;instance_60_3_4_10_9_Sthr_1.txt;60;3;4;600;0; ; ; ; ; ; ; 
jobBased.exe;T39_small;small;instance_60_3_4_10_9_Sthr_2.txt;60;3;4;600.011;1;1885;1877;8;8;5;1;1;0
jobBased.exe;T39_small;small;instance_60_3_4_10_9_Sthr_3.txt;60;3;4;600.01;1;4082;4075;7;7;2;1;1;0
jobBased.exe;T39_small;small;instance_60_3_4_10_9_Sthr_4.txt;60;3;4;600.012;1;2835;2829;6;6;4;1;1;0
jobBased.exe;T39_small;small;instance_60_3_4_10_9_Sthr_5.txt;60;3;4;600;0; ; ; ; ; ; ; 
jobBased.exe;T39_small;small;instance_60_3_4_10_9_Sthr_6.txt;60;3;4;600.01;1;2185;2178;7;7;2;1;1;0
jobBased.exe;T39_small;small;instance_60_3_4_10_9_Sthr_7.txt;60;3;4;600.009;1;3001;2994;7;7;2;1;1;0
jobBased.exe;T39_small;small;instance_60_3_4_10_9_Sthr_8.txt;60;3;4;600.014;1;1012;1006;6;6;7;1;1;0
jobBased.exe;T39_small;small;instance_60_3_4_10_9_Sthr_9.txt;60;3;4;600.012;1;1445;1439;6;6;6;1;1;0
jobBased.exe;T40_big;big;instance_60_3_5_10_11_Bthr_0.txt;60;3;5;600;0; ; ; ; ; ; ; 
jobBased.exe;T40_big;big;instance_60_3_5_10_11_Bthr_1.txt;60;3;5;600.009;1;2742;2733;9;9;6;1;1;0
jobBased.exe;T40_big;big;instance_60_3_5_10_11_Bthr_2.txt;60;3;5;600.009;1;2331;2323;8;8;8;1;1;0
jobBased.exe;T40_big;big;instance_60_3_5_10_11_Bthr_3.txt;60;3;5;600.009;1;1863;1859;4;4;15;1;1;0
jobBased.exe;T40_big;big;instance_60_3_5_10_11_Bthr_4.txt;60;3;5;600;0; ; ; ; ; ; ; 
jobBased.exe;T40_big;big;instance_60_3_5_10_11_Bthr_5.txt;60;3;5;600.01;1;2910;2903;7;7;6;1;1;0
jobBased.exe;T40_big;big;instance_60_3_5_10_11_Bthr_6.txt;60;3;5;600;0; ; ; ; ; ; ; 
jobBased.exe;T40_big;big;instance_60_3_5_10_11_Bthr_7.txt;60;3;5;600;0; ; ; ; ; ; ; 
jobBased.exe;T40_big;big;instance_60_3_5_10_11_Bthr_8.txt;60;3;5;600.011;1;1900;1890;10;10;3;1;1;0
jobBased.exe;T40_big;big;instance_60_3_5_10_11_Bthr_9.txt;60;3;5;600.007;1;2585;2576;9;9;3;1;1;0
jobBased.exe;T40_medium;medium;instance_60_3_5_10_11_Mthr_0.txt;60;3;5;600.007;1;1546;1539;7;7;8;1;1;0
jobBased.exe;T40_medium;medium;instance_60_3_5_10_11_Mthr_1.txt;60;3;5;600.01;1;2069;2062;7;7;8;1;1;0
jobBased.exe;T40_medium;medium;instance_60_3_5_10_11_Mthr_2.txt;60;3;5;600;0; ; ; ; ; ; ; 
jobBased.exe;T40_medium;medium;instance_60_3_5_10_11_Mthr_3.txt;60;3;5;600.01;1;1779;1772;7;7;12;1;1;0
jobBased.exe;T40_medium;medium;instance_60_3_5_10_11_Mthr_4.txt;60;3;5;600;0; ; ; ; ; ; ; 
jobBased.exe;T40_medium;medium;instance_60_3_5_10_11_Mthr_5.txt;60;3;5;600.008;1;2963;2954;9;9;5;1;1;0
jobBased.exe;T40_medium;medium;instance_60_3_5_10_11_Mthr_6.txt;60;3;5;600;0; ; ; ; ; ; ; 
jobBased.exe;T40_medium;medium;instance_60_3_5_10_11_Mthr_7.txt;60;3;5;600.009;1;2870;2862;8;8;4;1;1;0
jobBased.exe;T40_medium;medium;instance_60_3_5_10_11_Mthr_8.txt;60;3;5;600.009;1;2484;2476;8;8;8;1;1;0
jobBased.exe;T40_medium;medium;instance_60_3_5_10_11_Mthr_9.txt;60;3;5;600;0; ; ; ; ; ; ; 
jobBased.exe;T40_small;small;instance_60_3_5_10_11_Sthr_0.txt;60;3;5;600;0; ; ; ; ; ; ; 
jobBased.exe;T40_small;small;instance_60_3_5_10_11_Sthr_1.txt;60;3;5;600;0; ; ; ; ; ; ; 
jobBased.exe;T40_small;small;instance_60_3_5_10_11_Sthr_2.txt;60;3;5;600.011;1;1119;1111;8;8;5;1;1;0
jobBased.exe;T40_small;small;instance_60_3_5_10_11_Sthr_3.txt;60;3;5;600;0; ; ; ; ; ; ; 
jobBased.exe;T40_small;small;instance_60_3_5_10_11_Sthr_4.txt;60;3;5;600;0; ; ; ; ; ; ; 
jobBased.exe;T40_small;small;instance_60_3_5_10_11_Sthr_5.txt;60;3;5;600;0; ; ; ; ; ; ; 
jobBased.exe;T40_small;small;instance_60_3_5_10_11_Sthr_6.txt;60;3;5;600;0; ; ; ; ; ; ; 
jobBased.exe;T40_small;small;instance_60_3_5_10_11_Sthr_7.txt;60;3;5;600.007;1;3708;3699;9;9;5;1;1;0
jobBased.exe;T40_small;small;instance_60_3_5_10_11_Sthr_8.txt;60;3;5;600;0; ; ; ; ; ; ; 
jobBased.exe;T40_small;small;instance_60_3_5_10_11_Sthr_9.txt;60;3;5;600;0; ; ; ; ; ; ; 
jobBased.exe;T44_big;big;instance_70_3_5_10_12_Bthr_0.txt;70;3;5;600.011;1;1946;1937;9;9;8;1;1;0
jobBased.exe;T44_big;big;instance_70_3_5_10_12_Bthr_1.txt;70;3;5;600;0; ; ; ; ; ; ; 
jobBased.exe;T44_big;big;instance_70_3_5_10_12_Bthr_2.txt;70;3;5;600;0; ; ; ; ; ; ; 
jobBased.exe;T44_big;big;instance_70_3_5_10_12_Bthr_3.txt;70;3;5;600;0; ; ; ; ; ; ; 
jobBased.exe;T44_big;big;instance_70_3_5_10_12_Bthr_4.txt;70;3;5;600.012;1;1845;1837;8;8;8;1;1;0
jobBased.exe;T44_big;big;instance_70_3_5_10_12_Bthr_5.txt;70;3;5;600;0; ; ; ; ; ; ; 
jobBased.exe;T44_big;big;instance_70_3_5_10_12_Bthr_6.txt;70;3;5;600;0; ; ; ; ; ; ; 
jobBased.exe;T44_big;big;instance_70_3_5_10_12_Bthr_7.txt;70;3;5;600;0; ; ; ; ; ; ; 
jobBased.exe;T44_big;big;instance_70_3_5_10_12_Bthr_8.txt;70;3;5;600;0; ; ; ; ; ; ; 
jobBased.exe;T44_big;big;instance_70_3_5_10_12_Bthr_9.txt;70;3;5;600;0; ; ; ; ; ; ; 
jobBased.exe;T44_medium;medium;instance_70_3_5_10_12_Mthr_0.txt;70;3;5;600.01;1;2673;2662;11;11;6;1;1;0
jobBased.exe;T44_medium;medium;instance_70_3_5_10_12_Mthr_1.txt;70;3;5;600;0; ; ; ; ; ; ; 
jobBased.exe;T44_medium;medium;instance_70_3_5_10_12_Mthr_2.txt;70;3;5;600;0; ; ; ; ; ; ; 
jobBased.exe;T44_medium;medium;instance_70_3_5_10_12_Mthr_3.txt;70;3;5;600;0; ; ; ; ; ; ; 
jobBased.exe;T44_medium;medium;instance_70_3_5_10_12_Mthr_4.txt;70;3;5;600;0; ; ; ; ; ; ; 
jobBased.exe;T44_medium;medium;instance_70_3_5_10_12_Mthr_5.txt;70;3;5;600.011;1;2740;2731;9;9;5;1;1;0
jobBased.exe;T44_medium;medium;instance_70_3_5_10_12_Mthr_6.txt;70;3;5;600;0; ; ; ; ; ; ; 
jobBased.exe;T44_medium;medium;instance_70_3_5_10_12_Mthr_7.txt;70;3;5;600;0; ; ; ; ; ; ; 
jobBased.exe;T44_medium;medium;instance_70_3_5_10_12_Mthr_8.txt;70;3;5;600;0; ; ; ; ; ; ; 
jobBased.exe;T44_medium;medium;instance_70_3_5_10_12_Mthr_9.txt;70;3;5;600;0; ; ; ; ; ; ; 
jobBased.exe;T44_small;small;instance_70_3_5_10_12_Sthr_0.txt;70;3;5;600;0; ; ; ; ; ; ; 
jobBased.exe;T44_small;small;instance_70_3_5_10_12_Sthr_1.txt;70;3;5;600;0; ; ; ; ; ; ; 
jobBased.exe;T44_small;small;instance_70_3_5_10_12_Sthr_2.txt;70;3;5;600;0; ; ; ; ; ; ; 
jobBased.exe;T44_small;small;instance_70_3_5_10_12_Sthr_3.txt;70;3;5;600;0; ; ; ; ; ; ; 
jobBased.exe;T44_small;small;instance_70_3_5_10_12_Sthr_4.txt;70;3;5;600;0; ; ; ; ; ; ; 
jobBased.exe;T44_small;small;instance_70_3_5_10_12_Sthr_5.txt;70;3;5;600;0; ; ; ; ; ; ; 
jobBased.exe;T44_small;small;instance_70_3_5_10_12_Sthr_6.txt;70;3;5;600;0; ; ; ; ; ; ; 
jobBased.exe;T44_small;small;instance_70_3_5_10_12_Sthr_7.txt;70;3;5;600;0; ; ; ; ; ; ; 
jobBased.exe;T44_small;small;instance_70_3_5_10_12_Sthr_8.txt;70;3;5;600;0; ; ; ; ; ; ; 
jobBased.exe;T44_small;small;instance_70_3_5_10_12_Sthr_9.txt;70;3;5;600;0; ; ; ; ; ; ; 
jobBased.exe;T45_big;big;instance_70_4_4_10_9_Bthr_0.txt;70;4;4;600.014;1;2354;2349;5;5;4;1;1;0
jobBased.exe;T45_big;big;instance_70_4_4_10_9_Bthr_1.txt;70;4;4;600.013;1;4255;4249;6;6;3;1;1;0
jobBased.exe;T45_big;big;instance_70_4_4_10_9_Bthr_2.txt;70;4;4;600.014;1;6342;6336;6;6;5;1;1;0
jobBased.exe;T45_big;big;instance_70_4_4_10_9_Bthr_3.txt;70;4;4;600.012;1;3752;3747;5;5;7;1;1;0
jobBased.exe;T45_big;big;instance_70_4_4_10_9_Bthr_4.txt;70;4;4;600.012;1;4401;4396;5;5;6;1;1;0
jobBased.exe;T45_big;big;instance_70_4_4_10_9_Bthr_5.txt;70;4;4;600.011;1;2538;2533;5;5;2;1;1;0
jobBased.exe;T45_big;big;instance_70_4_4_10_9_Bthr_6.txt;70;4;4;600.009;1;4293;4288;5;5;2;1;1;0
jobBased.exe;T45_big;big;instance_70_4_4_10_9_Bthr_7.txt;70;4;4;600.012;1;3363;3356;7;7;1;1;1;0
jobBased.exe;T45_big;big;instance_70_4_4_10_9_Bthr_8.txt;70;4;4;600.017;1;4071;4065;6;6;3;1;1;0
jobBased.exe;T45_big;big;instance_70_4_4_10_9_Bthr_9.txt;70;4;4;600.015;1;1887;1882;5;5;7;1;1;0
jobBased.exe;T45_medium;medium;instance_70_4_4_10_9_Mthr_0.txt;70;4;4;600.012;1;2878;2873;5;5;5;1;1;0
jobBased.exe;T45_medium;medium;instance_70_4_4_10_9_Mthr_1.txt;70;4;4;600.014;1;2623;2618;5;5;7;1;1;0
jobBased.exe;T45_medium;medium;instance_70_4_4_10_9_Mthr_2.txt;70;4;4;600.012;1;2656;2651;5;5;6;1;1;0
jobBased.exe;T45_medium;medium;instance_70_4_4_10_9_Mthr_3.txt;70;4;4;600.011;1;3944;3936;8;8;2;1;1;0
jobBased.exe;T45_medium;medium;instance_70_4_4_10_9_Mthr_4.txt;70;4;4;600.013;1;4139;4132;7;7;0;1;1;0
jobBased.exe;T45_medium;medium;instance_70_4_4_10_9_Mthr_5.txt;70;4;4;600.012;1;2627;2622;5;5;6;1;1;0
jobBased.exe;T45_medium;medium;instance_70_4_4_10_9_Mthr_6.txt;70;4;4;600.012;1;3506;3500;6;6;4;1;1;0
jobBased.exe;T45_medium;medium;instance_70_4_4_10_9_Mthr_7.txt;70;4;4;600.015;1;5846;5842;4;4;9;1;1;0
jobBased.exe;T45_medium;medium;instance_70_4_4_10_9_Mthr_8.txt;70;4;4;600.014;1;3999;3993;6;6;3;1;1;0
jobBased.exe;T45_medium;medium;instance_70_4_4_10_9_Mthr_9.txt;70;4;4;600.013;1;2747;2742;5;5;8;1;1;0
jobBased.exe;T45_small;small;instance_70_4_4_10_9_Sthr_0.txt;70;4;4;600.012;1;5552;5546;6;6;1;1;1;0
jobBased.exe;T45_small;small;instance_70_4_4_10_9_Sthr_1.txt;70;4;4;600.012;1;2540;2532;8;8;1;1;1;0
jobBased.exe;T45_small;small;instance_70_4_4_10_9_Sthr_2.txt;70;4;4;600.013;1;2660;2654;6;6;7;1;1;0
jobBased.exe;T45_small;small;instance_70_4_4_10_9_Sthr_3.txt;70;4;4;600.011;1;2873;2865;8;8;1;1;1;0
jobBased.exe;T45_small;small;instance_70_4_4_10_9_Sthr_4.txt;70;4;4;600;0; ; ; ; ; ; ; 
jobBased.exe;T45_small;small;instance_70_4_4_10_9_Sthr_5.txt;70;4;4;600.012;1;3736;3729;7;7;1;1;1;0
jobBased.exe;T45_small;small;instance_70_4_4_10_9_Sthr_6.txt;70;4;4;600.014;1;1036;1029;7;7;2;1;1;0
jobBased.exe;T45_small;small;instance_70_4_4_10_9_Sthr_7.txt;70;4;4;600.011;1;4165;4159;6;6;2;1;1;0
jobBased.exe;T45_small;small;instance_70_4_4_10_9_Sthr_8.txt;70;4;4;600.011;1;4792;4785;7;7;1;1;1;0
jobBased.exe;T45_small;small;instance_70_4_4_10_9_Sthr_9.txt;70;4;4;600.012;1;4233;4225;8;8;4;1;1;0
jobBased.exe;T46_big;big;instance_70_4_5_10_14_Bthr_0.txt;70;4;5;600;0; ; ; ; ; ; ; 
jobBased.exe;T46_big;big;instance_70_4_5_10_14_Bthr_1.txt;70;4;5;600.014;1;3082;3071;11;11;6;1;1;0
jobBased.exe;T46_big;big;instance_70_4_5_10_14_Bthr_2.txt;70;4;5;600.012;1;4720;4708;12;12;2;1;1;0
jobBased.exe;T46_big;big;instance_70_4_5_10_14_Bthr_3.txt;70;4;5;600.013;1;2665;2656;9;9;6;1;1;0
jobBased.exe;T46_big;big;instance_70_4_5_10_14_Bthr_4.txt;70;4;5;600.016;1;2070;2059;11;11;8;1;1;0
jobBased.exe;T46_big;big;instance_70_4_5_10_14_Bthr_5.txt;70;4;5;600.018;1;2071;2059;12;12;5;1;1;0
jobBased.exe;T46_big;big;instance_70_4_5_10_14_Bthr_6.txt;70;4;5;600.016;1;3041;3031;10;10;3;1;1;0
jobBased.exe;T46_big;big;instance_70_4_5_10_14_Bthr_7.txt;70;4;5;600.015;1;4254;4244;10;10;9;1;1;0
jobBased.exe;T46_big;big;instance_70_4_5_10_14_Bthr_8.txt;70;4;5;600.013;1;2361;2351;10;10;9;1;1;0
jobBased.exe;T46_big;big;instance_70_4_5_10_14_Bthr_9.txt;70;4;5;600.019;1;2125;2115;10;10;9;1;1;0
jobBased.exe;T46_medium;medium;instance_70_4_5_10_14_Mthr_0.txt;70;4;5;600;0; ; ; ; ; ; ; 
jobBased.exe;T46_medium;medium;instance_70_4_5_10_14_Mthr_1.txt;70;4;5;600.014;1;3353;3341;12;12;10;1;1;0
jobBased.exe;T46_medium;medium;instance_70_4_5_10_14_Mthr_2.txt;70;4;5;600.013;1;3835;3822;13;13;6;1;1;0
jobBased.exe;T46_medium;medium;instance_70_4_5_10_14_Mthr_3.txt;70;4;5;600.014;1;2297;2285;12;12;7;1;1;0
jobBased.exe;T46_medium;medium;instance_70_4_5_10_14_Mthr_4.txt;70;4;5;600;0; ; ; ; ; ; ; 
jobBased.exe;T46_medium;medium;instance_70_4_5_10_14_Mthr_5.txt;70;4;5;600.012;1;1455;1451;4;4;12;1;1;0
jobBased.exe;T46_medium;medium;instance_70_4_5_10_14_Mthr_6.txt;70;4;5;600;0; ; ; ; ; ; ; 
jobBased.exe;T46_medium;medium;instance_70_4_5_10_14_Mthr_7.txt;70;4;5;600;0; ; ; ; ; ; ; 
jobBased.exe;T46_medium;medium;instance_70_4_5_10_14_Mthr_8.txt;70;4;5;600.013;1;2701;2691;10;10;8;1;1;0
jobBased.exe;T46_medium;medium;instance_70_4_5_10_14_Mthr_9.txt;70;4;5;600;0; ; ; ; ; ; ; 
jobBased.exe;T46_small;small;instance_70_4_5_10_14_Sthr_0.txt;70;4;5;600;0; ; ; ; ; ; ; 
jobBased.exe;T46_small;small;instance_70_4_5_10_14_Sthr_1.txt;70;4;5;600;0; ; ; ; ; ; ; 
jobBased.exe;T46_small;small;instance_70_4_5_10_14_Sthr_2.txt;70;4;5;600.015;1;2957;2946;11;11;7;1;1;0
jobBased.exe;T46_small;small;instance_70_4_5_10_14_Sthr_3.txt;70;4;5;600;0; ; ; ; ; ; ; 
jobBased.exe;T46_small;small;instance_70_4_5_10_14_Sthr_4.txt;70;4;5;600;0; ; ; ; ; ; ; 
jobBased.exe;T46_small;small;instance_70_4_5_10_14_Sthr_5.txt;70;4;5;600.013;1;3325;3313;12;12;4;1;1;0
jobBased.exe;T46_small;small;instance_70_4_5_10_14_Sthr_6.txt;70;4;5;600.01;1;3580;3569;11;11;14;1;1;0
jobBased.exe;T46_small;small;instance_70_4_5_10_14_Sthr_7.txt;70;4;5;600.014;1;3701;3688;13;13;4;1;1;0
jobBased.exe;T46_small;small;instance_70_4_5_10_14_Sthr_8.txt;70;4;5;600;0; ; ; ; ; ; ; 
jobBased.exe;T46_small;small;instance_70_4_5_10_14_Sthr_9.txt;70;4;5;600;0; ; ; ; ; ; ; 
