methode;type;threshold;nom_instance;N;M;F;tps;solv;obj;obj1;obj2;obj22;setup;valide;feas;opt 
IP3.exe;T14_big;big;instance_20_3_4_10_8_Bthr_0.txt;20;3;4;4.625;1;433;429;4;4;2;1;1;1
IP3.exe;T14_big;big;instance_20_3_4_10_8_Bthr_1.txt;20;3;4;3.031;1;337;337;0;0;1;1;1;1
IP3.exe;T14_big;big;instance_20_3_4_10_8_Bthr_2.txt;20;3;4;1.281;1;264;262;2;2;1;1;1;1
IP3.exe;T14_big;big;instance_20_3_4_10_8_Bthr_3.txt;20;3;4;4.046;1;411;410;1;1;4;1;1;1
IP3.exe;T14_big;big;instance_20_3_4_10_8_Bthr_4.txt;20;3;4;4.156;1;480;476;4;4;2;1;1;1
IP3.exe;T14_big;big;instance_20_3_4_10_8_Bthr_5.txt;20;3;4;3.141;1;227;223;4;4;2;1;1;1
IP3.exe;T14_big;big;instance_20_3_4_10_8_Bthr_6.txt;20;3;4;6.594;1;413;413;0;0;4;1;1;1
IP3.exe;T14_big;big;instance_20_3_4_10_8_Bthr_7.txt;20;3;4;4.422;1;427;424;3;3;3;1;1;1
IP3.exe;T14_big;big;instance_20_3_4_10_8_Bthr_8.txt;20;3;4;3.812;1;437;432;5;5;1;1;1;1
IP3.exe;T14_big;big;instance_20_3_4_10_8_Bthr_9.txt;20;3;4;3.687;1;427;425;2;2;3;1;1;1
IP3.exe;T14_medium;medium;instance_20_3_4_10_8_Mthr_0.txt;20;3;4;0.719;1;141;141;0;0;3;1;1;1
IP3.exe;T14_medium;medium;instance_20_3_4_10_8_Mthr_1.txt;20;3;4;2.36;1;370;363;7;7;2;1;1;1
IP3.exe;T14_medium;medium;instance_20_3_4_10_8_Mthr_2.txt;20;3;4;3.781;1;322;318;4;4;2;1;1;1
IP3.exe;T14_medium;medium;instance_20_3_4_10_8_Mthr_3.txt;20;3;4;0.594;1;148;143;5;5;2;1;1;1
IP3.exe;T14_medium;medium;instance_20_3_4_10_8_Mthr_4.txt;20;3;4;2.531;1;211;211;0;0;5;1;1;1
IP3.exe;T14_medium;medium;instance_20_3_4_10_8_Mthr_5.txt;20;3;4;15.968;1;603;598;5;5;1;1;1;1
IP3.exe;T14_medium;medium;instance_20_3_4_10_8_Mthr_6.txt;20;3;4;4.14;1;319;317;2;2;3;1;1;1
IP3.exe;T14_medium;medium;instance_20_3_4_10_8_Mthr_7.txt;20;3;4;3.469;1;360;357;3;3;3;1;1;1
IP3.exe;T14_medium;medium;instance_20_3_4_10_8_Mthr_8.txt;20;3;4;8.234;1;427;424;3;3;3;1;1;1
IP3.exe;T14_medium;medium;instance_20_3_4_10_8_Mthr_9.txt;20;3;4;3.672;1;336;331;5;5;2;1;1;1
IP3.exe;T14_small;small;instance_20_3_4_10_8_Sthr_0.txt;20;3;4;5.89;1;378;373;5;5;3;1;1;1
IP3.exe;T14_small;small;instance_20_3_4_10_8_Sthr_1.txt;20;3;4;7.984;1;367;363;4;4;3;1;1;1
IP3.exe;T14_small;small;instance_20_3_4_10_8_Sthr_2.txt;20;3;4;3.25;1;274;269;5;5;1;1;1;1
IP3.exe;T14_small;small;instance_20_3_4_10_8_Sthr_3.txt;20;3;4;4.485;1;366;363;3;3;5;1;1;1
IP3.exe;T14_small;small;instance_20_3_4_10_8_Sthr_4.txt;20;3;4;2.188;1;175;170;5;5;4;1;1;1
IP3.exe;T14_small;small;instance_20_3_4_10_8_Sthr_5.txt;20;3;4;4.703;1;307;303;4;4;4;1;1;1
IP3.exe;T14_small;small;instance_20_3_4_10_8_Sthr_6.txt;20;3;4;2.282;1;278;273;5;5;3;1;1;1
IP3.exe;T14_small;small;instance_20_3_4_10_8_Sthr_7.txt;20;3;4;1.656;1;191;187;4;4;3;1;1;1
IP3.exe;T14_small;small;instance_20_3_4_10_8_Sthr_8.txt;20;3;4;5.89;1;409;404;5;5;3;1;1;1
IP3.exe;T14_small;small;instance_20_3_4_10_8_Sthr_9.txt;20;3;4;3.688;1;343;338;5;5;3;1;1;1
IP3.exe;T15_big;big;instance_20_3_5_10_9_Bthr_0.txt;20;3;5;2.469;1;292;292;0;0;3;1;1;1
IP3.exe;T15_big;big;instance_20_3_5_10_9_Bthr_1.txt;20;3;5;5.391;1;369;369;0;0;2;1;1;1
IP3.exe;T15_big;big;instance_20_3_5_10_9_Bthr_2.txt;20;3;5;5.156;1;428;422;6;6;2;1;1;1
IP3.exe;T15_big;big;instance_20_3_5_10_9_Bthr_3.txt;20;3;5;2.5;1;267;267;0;0;4;1;1;1
IP3.exe;T15_big;big;instance_20_3_5_10_9_Bthr_4.txt;20;3;5;22.719;1;667;662;5;5;3;1;1;1
IP3.exe;T15_big;big;instance_20_3_5_10_9_Bthr_5.txt;20;3;5;5.438;1;376;375;1;1;3;1;1;1
IP3.exe;T15_big;big;instance_20_3_5_10_9_Bthr_6.txt;20;3;5;4.11;1;355;352;3;3;2;1;1;1
IP3.exe;T15_big;big;instance_20_3_5_10_9_Bthr_7.txt;20;3;5;3.297;1;323;323;0;0;4;1;1;1
IP3.exe;T15_big;big;instance_20_3_5_10_9_Bthr_8.txt;20;3;5;3.047;1;294;294;0;0;3;1;1;1
IP3.exe;T15_big;big;instance_20_3_5_10_9_Bthr_9.txt;20;3;5;1.578;1;251;243;8;8;3;1;1;1
IP3.exe;T15_medium;medium;instance_20_3_5_10_9_Mthr_0.txt;20;3;5;2.36;1;284;277;7;7;4;1;1;1
IP3.exe;T15_medium;medium;instance_20_3_5_10_9_Mthr_1.txt;20;3;5;6.781;1;405;399;6;6;2;1;1;1
IP3.exe;T15_medium;medium;instance_20_3_5_10_9_Mthr_2.txt;20;3;5;13.891;1;468;465;3;3;4;1;1;1
IP3.exe;T15_medium;medium;instance_20_3_5_10_9_Mthr_3.txt;20;3;5;2.844;1;347;339;8;8;2;1;1;1
IP3.exe;T15_medium;medium;instance_20_3_5_10_9_Mthr_4.txt;20;3;5;3.172;1;232;232;0;0;4;1;1;1
IP3.exe;T15_medium;medium;instance_20_3_5_10_9_Mthr_5.txt;20;3;5;3.406;1;349;342;7;7;2;1;1;1
IP3.exe;T15_medium;medium;instance_20_3_5_10_9_Mthr_6.txt;20;3;5;14.406;1;408;404;4;4;4;1;1;1
IP3.exe;T15_medium;medium;instance_20_3_5_10_9_Mthr_7.txt;20;3;5;3.219;1;321;317;4;4;3;1;1;1
IP3.exe;T15_medium;medium;instance_20_3_5_10_9_Mthr_8.txt;20;3;5;6.078;1;419;416;3;3;5;1;1;1
IP3.exe;T15_medium;medium;instance_20_3_5_10_9_Mthr_9.txt;20;3;5;3.047;1;353;346;7;7;3;1;1;1
IP3.exe;T15_small;small;instance_20_3_5_10_9_Sthr_0.txt;20;3;5;25.984;1;470;466;4;4;7;1;1;1
IP3.exe;T15_small;small;instance_20_3_5_10_9_Sthr_1.txt;20;3;5;6.578;1;342;336;6;6;3;1;1;1
IP3.exe;T15_small;small;instance_20_3_5_10_9_Sthr_2.txt;20;3;5;5.125;1;387;381;6;6;4;1;1;1
IP3.exe;T15_small;small;instance_20_3_5_10_9_Sthr_3.txt;20;3;5;40.063;1;687;681;6;6;3;1;1;1
IP3.exe;T15_small;small;instance_20_3_5_10_9_Sthr_4.txt;20;3;5;11.188;1;472;465;7;7;2;1;1;1
IP3.exe;T15_small;small;instance_20_3_5_10_9_Sthr_5.txt;20;3;5;17.938;1;424;419;5;5;3;1;1;1
IP3.exe;T15_small;small;instance_20_3_5_10_9_Sthr_6.txt;20;3;5;3.329;1;289;283;6;6;4;1;1;1
IP3.exe;T15_small;small;instance_20_3_5_10_9_Sthr_7.txt;20;3;5;8.891;1;419;413;6;6;4;1;1;1
IP3.exe;T15_small;small;instance_20_3_5_10_9_Sthr_8.txt;20;3;5;5.781;1;454;447;7;7;2;1;1;1
IP3.exe;T15_small;small;instance_20_3_5_10_9_Sthr_9.txt;20;3;5;23.093;1;489;483;6;6;4;1;1;1
IP3.exe;T16_big;big;instance_20_4_2_10_6_Bthr_0.txt;20;4;2;2.422;1;414;414;0;0;2;1;1;1
IP3.exe;T16_big;big;instance_20_4_2_10_6_Bthr_1.txt;20;4;2;1.625;1;314;314;0;0;1;1;1;1
IP3.exe;T16_big;big;instance_20_4_2_10_6_Bthr_2.txt;20;4;2;1.469;1;276;276;0;0;2;1;1;1
IP3.exe;T16_big;big;instance_20_4_2_10_6_Bthr_3.txt;20;4;2;3.234;1;404;404;0;0;2;1;1;1
IP3.exe;T16_big;big;instance_20_4_2_10_6_Bthr_4.txt;20;4;2;1.375;1;251;251;0;0;2;1;1;1
IP3.exe;T16_big;big;instance_20_4_2_10_6_Bthr_5.txt;20;4;2;3.203;1;465;463;2;2;0;1;1;1
IP3.exe;T16_big;big;instance_20_4_2_10_6_Bthr_6.txt;20;4;2;5.328;1;540;540;0;0;0;1;1;1
IP3.exe;T16_big;big;instance_20_4_2_10_6_Bthr_7.txt;20;4;2;1.5;1;272;272;0;0;0;1;1;1
IP3.exe;T16_big;big;instance_20_4_2_10_6_Bthr_8.txt;20;4;2;1.031;1;226;226;0;0;2;1;1;1
IP3.exe;T16_big;big;instance_20_4_2_10_6_Bthr_9.txt;20;4;2;1.485;1;589;585;4;4;0;1;1;1
IP3.exe;T16_medium;medium;instance_20_4_2_10_6_Mthr_0.txt;20;4;2;4.86;1;524;524;0;0;2;1;1;1
IP3.exe;T16_medium;medium;instance_20_4_2_10_6_Mthr_1.txt;20;4;2;0.187;1;95;95;0;0;1;1;1;1
IP3.exe;T16_medium;medium;instance_20_4_2_10_6_Mthr_2.txt;20;4;2;0.406;1;184;180;4;4;0;1;1;1
IP3.exe;T16_medium;medium;instance_20_4_2_10_6_Mthr_3.txt;20;4;2;3.797;1;420;420;0;0;2;1;1;1
IP3.exe;T16_medium;medium;instance_20_4_2_10_6_Mthr_4.txt;20;4;2;1.265;1;268;265;3;3;2;1;1;1
IP3.exe;T16_medium;medium;instance_20_4_2_10_6_Mthr_5.txt;20;4;2;1.609;1;317;315;2;2;0;1;1;1
IP3.exe;T16_medium;medium;instance_20_4_2_10_6_Mthr_6.txt;20;4;2;1.078;1;224;224;0;0;2;1;1;1
IP3.exe;T16_medium;medium;instance_20_4_2_10_6_Mthr_7.txt;20;4;2;1.547;1;422;420;2;2;0;1;1;1
IP3.exe;T16_medium;medium;instance_20_4_2_10_6_Mthr_8.txt;20;4;2;1.328;1;253;252;1;1;1;1;1;1
IP3.exe;T16_medium;medium;instance_20_4_2_10_6_Mthr_9.txt;20;4;2;2.969;1;364;364;0;0;1;1;1;1
IP3.exe;T16_small;small;instance_20_4_2_10_6_Sthr_0.txt;20;4;2;3.5;1;366;365;1;1;1;1;1;1
IP3.exe;T16_small;small;instance_20_4_2_10_6_Sthr_1.txt;20;4;2;2.25;1;308;306;2;2;0;1;1;1
IP3.exe;T16_small;small;instance_20_4_2_10_6_Sthr_2.txt;20;4;2;0.265;1;115;111;4;4;0;1;1;1
IP3.exe;T16_small;small;instance_20_4_2_10_6_Sthr_3.txt;20;4;2;1.578;1;280;280;0;0;2;1;1;1
IP3.exe;T16_small;small;instance_20_4_2_10_6_Sthr_4.txt;20;4;2;5.265;1;542;540;2;2;0;1;1;1
IP3.exe;T16_small;small;instance_20_4_2_10_6_Sthr_5.txt;20;4;2;2.469;1;276;275;1;1;1;1;1;1
IP3.exe;T16_small;small;instance_20_4_2_10_6_Sthr_6.txt;20;4;2;4.671;1;432;430;2;2;0;1;1;1
IP3.exe;T16_small;small;instance_20_4_2_10_6_Sthr_7.txt;20;4;2;2.203;1;304;303;1;1;2;1;1;1
IP3.exe;T16_small;small;instance_20_4_2_10_6_Sthr_8.txt;20;4;2;1.078;1;274;270;4;4;0;1;1;1
IP3.exe;T16_small;small;instance_20_4_2_10_6_Sthr_9.txt;20;4;2;2.86;1;400;399;1;1;1;1;1;1
IP3.exe;T17_big;big;instance_20_4_3_10_7_Bthr_0.txt;20;4;3;1.297;1;198;198;0;0;0;1;1;1
IP3.exe;T17_big;big;instance_20_4_3_10_7_Bthr_1.txt;20;4;3;2.141;1;329;329;0;0;2;1;1;1
IP3.exe;T17_big;big;instance_20_4_3_10_7_Bthr_2.txt;20;4;3;1.719;1;283;283;0;0;2;1;1;1
IP3.exe;T17_big;big;instance_20_4_3_10_7_Bthr_3.txt;20;4;3;7.735;1;498;497;1;1;1;1;1;1
IP3.exe;T17_big;big;instance_20_4_3_10_7_Bthr_4.txt;20;4;3;1.063;1;213;213;0;0;1;1;1;1
IP3.exe;T17_big;big;instance_20_4_3_10_7_Bthr_5.txt;20;4;3;3.984;1;388;388;0;0;1;1;1;1
IP3.exe;T17_big;big;instance_20_4_3_10_7_Bthr_6.txt;20;4;3;1.953;1;324;322;2;2;2;1;1;1
IP3.exe;T17_big;big;instance_20_4_3_10_7_Bthr_7.txt;20;4;3;1.375;1;221;221;0;0;3;1;1;1
IP3.exe;T17_big;big;instance_20_4_3_10_7_Bthr_8.txt;20;4;3;2.641;1;362;362;0;0;2;1;1;1
IP3.exe;T17_big;big;instance_20_4_3_10_7_Bthr_9.txt;20;4;3;7.016;1;490;487;3;3;0;1;1;1
IP3.exe;T17_medium;medium;instance_20_4_3_10_7_Mthr_0.txt;20;4;3;1.156;1;336;330;6;6;1;1;1;1
IP3.exe;T17_medium;medium;instance_20_4_3_10_7_Mthr_1.txt;20;4;3;4.172;1;354;354;0;0;3;1;1;1
IP3.exe;T17_medium;medium;instance_20_4_3_10_7_Mthr_2.txt;20;4;3;0.672;1;210;206;4;4;0;1;1;1
IP3.exe;T17_medium;medium;instance_20_4_3_10_7_Mthr_3.txt;20;4;3;4.172;1;561;556;5;5;0;1;1;1
IP3.exe;T17_medium;medium;instance_20_4_3_10_7_Mthr_4.txt;20;4;3;2.094;1;268;266;2;2;1;1;1;1
IP3.exe;T17_medium;medium;instance_20_4_3_10_7_Mthr_5.txt;20;4;3;3.484;1;404;402;2;2;1;1;1;1
IP3.exe;T17_medium;medium;instance_20_4_3_10_7_Mthr_6.txt;20;4;3;3.407;1;267;267;0;0;1;1;1;1
IP3.exe;T17_medium;medium;instance_20_4_3_10_7_Mthr_7.txt;20;4;3;1.844;1;328;326;2;2;2;1;1;1
IP3.exe;T17_medium;medium;instance_20_4_3_10_7_Mthr_8.txt;20;4;3;4.062;1;388;388;0;0;1;1;1;1
IP3.exe;T17_medium;medium;instance_20_4_3_10_7_Mthr_9.txt;20;4;3;3.984;1;426;423;3;3;1;1;1;1
IP3.exe;T17_small;small;instance_20_4_3_10_7_Sthr_0.txt;20;4;3;1.453;1;255;250;5;5;2;1;1;1
IP3.exe;T17_small;small;instance_20_4_3_10_7_Sthr_1.txt;20;4;3;3.844;1;380;377;3;3;3;1;1;1
IP3.exe;T17_small;small;instance_20_4_3_10_7_Sthr_2.txt;20;4;3;1.64;1;255;250;5;5;2;1;1;1
IP3.exe;T17_small;small;instance_20_4_3_10_7_Sthr_3.txt;20;4;3;9.485;1;686;680;6;6;2;1;1;1
IP3.exe;T17_small;small;instance_20_4_3_10_7_Sthr_4.txt;20;4;3;1.125;1;176;176;0;0;2;1;1;1
IP3.exe;T17_small;small;instance_20_4_3_10_7_Sthr_5.txt;20;4;3;1.406;1;399;393;6;6;2;1;1;1
IP3.exe;T17_small;small;instance_20_4_3_10_7_Sthr_6.txt;20;4;3;5.391;1;450;449;1;1;2;1;1;1
IP3.exe;T17_small;small;instance_20_4_3_10_7_Sthr_7.txt;20;4;3;4.078;1;283;280;3;3;2;1;1;1
IP3.exe;T17_small;small;instance_20_4_3_10_7_Sthr_8.txt;20;4;3;7.281;1;458;452;6;6;1;1;1;1
IP3.exe;T17_small;small;instance_20_4_3_10_7_Sthr_9.txt;20;4;3;5.234;1;409;407;2;2;3;1;1;1
IP3.exe;T18_big;big;instance_20_4_4_10_11_Bthr_0.txt;20;4;4;5.359;1;268;268;0;0;3;1;1;1
IP3.exe;T18_big;big;instance_20_4_4_10_11_Bthr_1.txt;20;4;4;29.172;1;516;514;2;2;2;1;1;1
IP3.exe;T18_big;big;instance_20_4_4_10_11_Bthr_2.txt;20;4;4;10.406;1;295;295;0;0;3;1;1;1
IP3.exe;T18_big;big;instance_20_4_4_10_11_Bthr_3.txt;20;4;4;17.36;1;474;474;0;0;4;1;1;1
IP3.exe;T18_big;big;instance_20_4_4_10_11_Bthr_4.txt;20;4;4;1.781;1;163;163;0;0;2;1;1;1
IP3.exe;T18_big;big;instance_20_4_4_10_11_Bthr_5.txt;20;4;4;9.047;1;440;430;10;10;2;1;1;1
IP3.exe;T18_big;big;instance_20_4_4_10_11_Bthr_6.txt;20;4;4;9.922;1;363;363;0;0;4;1;1;1
IP3.exe;T18_big;big;instance_20_4_4_10_11_Bthr_7.txt;20;4;4;9.937;1;310;310;0;0;3;1;1;1
IP3.exe;T18_big;big;instance_20_4_4_10_11_Bthr_8.txt;20;4;4;1.969;1;152;152;0;0;5;1;1;1
IP3.exe;T18_big;big;instance_20_4_4_10_11_Bthr_9.txt;20;4;4;7.047;1;301;301;0;0;3;1;1;1
IP3.exe;T18_medium;medium;instance_20_4_4_10_11_Mthr_0.txt;20;4;4;3.453;1;227;227;0;0;4;1;1;1
IP3.exe;T18_medium;medium;instance_20_4_4_10_11_Mthr_1.txt;20;4;4;4.031;1;238;238;0;0;4;1;1;1
IP3.exe;T18_medium;medium;instance_20_4_4_10_11_Mthr_2.txt;20;4;4;5.703;1;261;261;0;0;4;1;1;1
IP3.exe;T18_medium;medium;instance_20_4_4_10_11_Mthr_3.txt;20;4;4;4.438;1;245;244;1;1;6;1;1;1
IP3.exe;T18_medium;medium;instance_20_4_4_10_11_Mthr_4.txt;20;4;4;12.219;1;430;423;7;7;3;1;1;1
IP3.exe;T18_medium;medium;instance_20_4_4_10_11_Mthr_5.txt;20;4;4;12.062;1;433;427;6;6;2;1;1;1
IP3.exe;T18_medium;medium;instance_20_4_4_10_11_Mthr_6.txt;20;4;4;3.969;1;240;237;3;3;3;1;1;1
IP3.exe;T18_medium;medium;instance_20_4_4_10_11_Mthr_7.txt;20;4;4;30.5;1;455;454;1;1;2;1;1;1
IP3.exe;T18_medium;medium;instance_20_4_4_10_11_Mthr_8.txt;20;4;4;4.938;1;260;260;0;0;5;1;1;1
IP3.exe;T18_medium;medium;instance_20_4_4_10_11_Mthr_9.txt;20;4;4;2.609;1;169;169;0;0;5;1;1;1
IP3.exe;T18_small;small;instance_20_4_4_10_11_Sthr_0.txt;20;4;4;8.329;1;358;352;6;6;4;1;1;1
IP3.exe;T18_small;small;instance_20_4_4_10_11_Sthr_1.txt;20;4;4;12.109;1;379;372;7;7;2;1;1;1
IP3.exe;T18_small;small;instance_20_4_4_10_11_Sthr_2.txt;20;4;4;16.828;1;361;354;7;7;3;1;1;1
IP3.exe;T18_small;small;instance_20_4_4_10_11_Sthr_3.txt;20;4;4;5.39;1;232;227;5;5;4;1;1;1
IP3.exe;T18_small;small;instance_20_4_4_10_11_Sthr_4.txt;20;4;4;17.109;1;460;453;7;7;3;1;1;1
IP3.exe;T18_small;small;instance_20_4_4_10_11_Sthr_5.txt;20;4;4;6.985;1;229;226;3;3;5;1;1;1
IP3.exe;T18_small;small;instance_20_4_4_10_11_Sthr_6.txt;20;4;4;24.046;1;334;330;4;4;5;1;1;1
IP3.exe;T18_small;small;instance_20_4_4_10_11_Sthr_7.txt;20;4;4;16.75;1;397;390;7;7;3;1;1;1
IP3.exe;T18_small;small;instance_20_4_4_10_11_Sthr_8.txt;20;4;4;13.172;1;327;324;3;3;2;1;1;1
IP3.exe;T18_small;small;instance_20_4_4_10_11_Sthr_9.txt;20;4;4;2.39;1;186;179;7;7;3;1;1;1
IP3.exe;T19_big;big;instance_20_4_5_10_13_Bthr_0.txt;20;4;5;5.172;1;212;212;0;0;4;1;1;1
IP3.exe;T19_big;big;instance_20_4_5_10_13_Bthr_1.txt;20;4;5;7.016;1;244;244;0;0;4;1;1;1
IP3.exe;T19_big;big;instance_20_4_5_10_13_Bthr_2.txt;20;4;5;5.843;1;229;229;0;0;4;1;1;1
IP3.exe;T19_big;big;instance_20_4_5_10_13_Bthr_3.txt;20;4;5;1.625;1;120;120;0;0;3;1;1;1
IP3.exe;T19_big;big;instance_20_4_5_10_13_Bthr_4.txt;20;4;5;10.546;1;291;291;0;0;4;1;1;1
IP3.exe;T19_big;big;instance_20_4_5_10_13_Bthr_5.txt;20;4;5;29.359;1;483;483;0;0;3;1;1;1
IP3.exe;T19_big;big;instance_20_4_5_10_13_Bthr_6.txt;20;4;5;3.312;1;181;181;0;0;3;1;1;1
IP3.exe;T19_big;big;instance_20_4_5_10_13_Bthr_7.txt;20;4;5;15.437;1;462;451;11;11;2;1;1;1
IP3.exe;T19_big;big;instance_20_4_5_10_13_Bthr_8.txt;20;4;5;2.297;1;118;118;0;0;5;1;1;1
IP3.exe;T19_big;big;instance_20_4_5_10_13_Bthr_9.txt;20;4;5;2.953;1;143;143;0;0;6;1;1;1
IP3.exe;T19_medium;medium;instance_20_4_5_10_13_Mthr_0.txt;20;4;5;7.953;1;265;265;0;0;4;1;1;1
IP3.exe;T19_medium;medium;instance_20_4_5_10_13_Mthr_1.txt;20;4;5;3.235;1;170;170;0;0;4;1;1;1
IP3.exe;T19_medium;medium;instance_20_4_5_10_13_Mthr_2.txt;20;4;5;4.688;1;249;240;9;9;3;1;1;1
IP3.exe;T19_medium;medium;instance_20_4_5_10_13_Mthr_3.txt;20;4;5;5.187;1;229;227;2;2;4;1;1;1
IP3.exe;T19_medium;medium;instance_20_4_5_10_13_Mthr_4.txt;20;4;5;5.781;1;225;225;0;0;2;1;1;1
IP3.exe;T19_medium;medium;instance_20_4_5_10_13_Mthr_5.txt;20;4;5;17.875;1;394;391;3;3;4;1;1;1
IP3.exe;T19_medium;medium;instance_20_4_5_10_13_Mthr_6.txt;20;4;5;11.547;1;297;297;0;0;4;1;1;1
IP3.exe;T19_medium;medium;instance_20_4_5_10_13_Mthr_7.txt;20;4;5;10.344;1;311;310;1;1;5;1;1;1
IP3.exe;T19_medium;medium;instance_20_4_5_10_13_Mthr_8.txt;20;4;5;14.812;1;368;362;6;6;4;1;1;1
IP3.exe;T19_medium;medium;instance_20_4_5_10_13_Mthr_9.txt;20;4;5;6.406;1;229;224;5;5;3;1;1;1
IP3.exe;T19_small;small;instance_20_4_5_10_13_Sthr_0.txt;20;4;5;20.953;1;320;316;4;4;5;1;1;1
IP3.exe;T19_small;small;instance_20_4_5_10_13_Sthr_1.txt;20;4;5;11.75;1;283;274;9;9;3;1;1;1
IP3.exe;T19_small;small;instance_20_4_5_10_13_Sthr_2.txt;20;4;5;8.171;1;243;236;7;7;6;1;1;1
IP3.exe;T19_small;small;instance_20_4_5_10_13_Sthr_3.txt;20;4;5;10.625;1;255;250;5;5;3;1;1;1
IP3.exe;T19_small;small;instance_20_4_5_10_13_Sthr_4.txt;20;4;5;7.734;1;224;221;3;3;5;1;1;1
IP3.exe;T19_small;small;instance_20_4_5_10_13_Sthr_5.txt;20;4;5;14.015;1;351;344;7;7;2;1;1;1
IP3.exe;T19_small;small;instance_20_4_5_10_13_Sthr_6.txt;20;4;5;11.079;1;300;292;8;8;4;1;1;1
IP3.exe;T19_small;small;instance_20_4_5_10_13_Sthr_7.txt;20;4;5;35.672;1;441;432;9;9;4;1;1;1
IP3.exe;T19_small;small;instance_20_4_5_10_13_Sthr_8.txt;20;4;5;41;1;385;377;8;8;2;1;1;1
IP3.exe;T19_small;small;instance_20_4_5_10_13_Sthr_9.txt;20;4;5;1.891;1;124;124;0;0;3;1;1;1
IP3.exe;T20_big;big;instance_30_3_2_10_4_Bthr_0.txt;30;3;2;2.953;1;1116;1115;1;1;1;1;1;1
IP3.exe;T20_big;big;instance_30_3_2_10_4_Bthr_1.txt;30;3;2;0.984;1;816;813;3;3;0;1;1;1
IP3.exe;T20_big;big;instance_30_3_2_10_4_Bthr_2.txt;30;3;2;1.422;1;651;650;1;1;1;1;1;1
IP3.exe;T20_big;big;instance_30_3_2_10_4_Bthr_3.txt;30;3;2;1.75;1;922;920;2;2;1;1;1;1
IP3.exe;T20_big;big;instance_30_3_2_10_4_Bthr_4.txt;30;3;2;0.906;1;682;680;2;2;1;1;1;1
IP3.exe;T20_big;big;instance_30_3_2_10_4_Bthr_5.txt;30;3;2;0.687;1;1242;1239;3;3;0;1;1;1
IP3.exe;T20_big;big;instance_30_3_2_10_4_Bthr_6.txt;30;3;2;0.531;1;491;488;3;3;0;1;1;1
IP3.exe;T20_big;big;instance_30_3_2_10_4_Bthr_7.txt;30;3;2;2.281;1;1323;1320;3;3;0;1;1;1
IP3.exe;T20_big;big;instance_30_3_2_10_4_Bthr_8.txt;30;3;2;4.141;1;1323;1320;3;3;0;1;1;1
IP3.exe;T20_big;big;instance_30_3_2_10_4_Bthr_9.txt;30;3;2;0.828;1;571;571;0;0;1;1;1;1
IP3.exe;T20_medium;medium;instance_30_3_2_10_4_Mthr_0.txt;30;3;2;0.859;1;601;600;1;1;0;1;1;1
IP3.exe;T20_medium;medium;instance_30_3_2_10_4_Mthr_1.txt;30;3;2;5.375;1;1241;1240;1;1;1;1;1;1
IP3.exe;T20_medium;medium;instance_30_3_2_10_4_Mthr_2.txt;30;3;2;1.25;1;673;672;1;1;1;1;1;1
IP3.exe;T20_medium;medium;instance_30_3_2_10_4_Mthr_3.txt;30;3;2;0.875;1;553;552;1;1;1;1;1;1
IP3.exe;T20_medium;medium;instance_30_3_2_10_4_Mthr_4.txt;30;3;2;1.609;1;779;778;1;1;1;1;1;1
IP3.exe;T20_medium;medium;instance_30_3_2_10_4_Mthr_5.txt;30;3;2;4.563;1;1170;1170;0;0;2;1;1;1
IP3.exe;T20_medium;medium;instance_30_3_2_10_4_Mthr_6.txt;30;3;2;0.406;1;370;370;0;0;1;1;1;1
IP3.exe;T20_medium;medium;instance_30_3_2_10_4_Mthr_7.txt;30;3;2;4.563;1;1323;1320;3;3;0;1;1;1
IP3.exe;T20_medium;medium;instance_30_3_2_10_4_Mthr_8.txt;30;3;2;4.766;1;1251;1250;1;1;1;1;1;1
IP3.exe;T20_medium;medium;instance_30_3_2_10_4_Mthr_9.txt;30;3;2;1.235;1;744;742;2;2;1;1;1;1
IP3.exe;T20_small;small;instance_30_3_2_10_4_Sthr_0.txt;30;3;2;4.484;1;991;990;1;1;1;1;1;1
IP3.exe;T20_small;small;instance_30_3_2_10_4_Sthr_1.txt;30;3;2;2.109;1;1587;1584;3;3;0;1;1;1
IP3.exe;T20_small;small;instance_30_3_2_10_4_Sthr_2.txt;30;3;2;8.735;1;1259;1258;1;1;1;1;1;1
IP3.exe;T20_small;small;instance_30_3_2_10_4_Sthr_3.txt;30;3;2;1.422;1;1720;1717;3;3;0;1;1;1
IP3.exe;T20_small;small;instance_30_3_2_10_4_Sthr_4.txt;30;3;2;1.391;1;900;898;2;2;0;1;1;1
IP3.exe;T20_small;small;instance_30_3_2_10_4_Sthr_5.txt;30;3;2;1.203;1;487;487;0;0;3;1;1;1
IP3.exe;T20_small;small;instance_30_3_2_10_4_Sthr_6.txt;30;3;2;0.421;1;425;423;2;2;1;1;1;1
IP3.exe;T20_small;small;instance_30_3_2_10_4_Sthr_7.txt;30;3;2;0.532;1;538;536;2;2;1;1;1;1
IP3.exe;T20_small;small;instance_30_3_2_10_4_Sthr_8.txt;30;3;2;0.672;1;513;510;3;3;0;1;1;1
IP3.exe;T20_small;small;instance_30_3_2_10_4_Sthr_9.txt;30;3;2;0.797;1;610;607;3;3;0;1;1;1
IP3.exe;T21_big;big;instance_30_3_3_10_7_Bthr_0.txt;30;3;3;20.531;1;1491;1485;6;6;1;1;1;1
IP3.exe;T21_big;big;instance_30_3_3_10_7_Bthr_1.txt;30;3;3;18.313;1;1177;1172;5;5;0;1;1;1
IP3.exe;T21_big;big;instance_30_3_3_10_7_Bthr_2.txt;30;3;3;7.469;1;863;857;6;6;2;1;1;1
IP3.exe;T21_big;big;instance_30_3_3_10_7_Bthr_3.txt;30;3;3;20.578;1;1175;1172;3;3;3;1;1;1
IP3.exe;T21_big;big;instance_30_3_3_10_7_Bthr_4.txt;30;3;3;9.75;1;872;871;1;1;4;1;1;1
IP3.exe;T21_big;big;instance_30_3_3_10_7_Bthr_5.txt;30;3;3;49.781;1;1057;1053;4;4;1;1;1;1
IP3.exe;T21_big;big;instance_30_3_3_10_7_Bthr_6.txt;30;3;3;3.234;1;520;515;5;5;3;1;1;1
IP3.exe;T21_big;big;instance_30_3_3_10_7_Bthr_7.txt;30;3;3;6.265;1;851;845;6;6;2;1;1;1
IP3.exe;T21_big;big;instance_30_3_3_10_7_Bthr_8.txt;30;3;3;8.734;1;840;838;2;2;4;1;1;1
IP3.exe;T21_big;big;instance_30_3_3_10_7_Bthr_9.txt;30;3;3;16.516;1;950;947;3;3;1;1;1;1
IP3.exe;T21_medium;medium;instance_30_3_3_10_7_Mthr_0.txt;30;3;3;12.391;1;842;839;3;3;4;1;1;1
IP3.exe;T21_medium;medium;instance_30_3_3_10_7_Mthr_1.txt;30;3;3;4.422;1;515;511;4;4;4;1;1;1
IP3.exe;T21_medium;medium;instance_30_3_3_10_7_Mthr_2.txt;30;3;3;10.203;1;884;880;4;4;2;1;1;1
IP3.exe;T21_medium;medium;instance_30_3_3_10_7_Mthr_3.txt;30;3;3;44.844;1;1196;1192;4;4;2;1;1;1
IP3.exe;T21_medium;medium;instance_30_3_3_10_7_Mthr_4.txt;30;3;3;13.875;1;837;836;1;1;4;1;1;1
IP3.exe;T21_medium;medium;instance_30_3_3_10_7_Mthr_5.txt;30;3;3;3.719;1;648;644;4;4;2;1;1;1
IP3.exe;T21_medium;medium;instance_30_3_3_10_7_Mthr_6.txt;30;3;3;11.656;1;968;964;4;4;3;1;1;1
IP3.exe;T21_medium;medium;instance_30_3_3_10_7_Mthr_7.txt;30;3;3;17.797;1;1249;1244;5;5;2;1;1;1
IP3.exe;T21_medium;medium;instance_30_3_3_10_7_Mthr_8.txt;30;3;3;14.25;1;1268;1263;5;5;2;1;1;1
IP3.exe;T21_medium;medium;instance_30_3_3_10_7_Mthr_9.txt;30;3;3;9.188;1;1519;1513;6;6;1;1;1;1
IP3.exe;T21_small;small;instance_30_3_3_10_7_Sthr_0.txt;30;3;3;80.468;1;1132;1130;2;2;7;1;1;1
IP3.exe;T21_small;small;instance_30_3_3_10_7_Sthr_1.txt;30;3;3;3.89;1;525;521;4;4;3;1;1;1
IP3.exe;T21_small;small;instance_30_3_3_10_7_Sthr_2.txt;30;3;3;147.734;1;1502;1498;4;4;1;1;1;1
IP3.exe;T21_small;small;instance_30_3_3_10_7_Sthr_3.txt;30;3;3;7.5;1;716;712;4;4;4;1;1;1
IP3.exe;T21_small;small;instance_30_3_3_10_7_Sthr_4.txt;30;3;3;1.562;1;333;330;3;3;3;1;1;1
IP3.exe;T21_small;small;instance_30_3_3_10_7_Sthr_5.txt;30;3;3;37.375;1;639;636;3;3;4;1;1;1
IP3.exe;T21_small;small;instance_30_3_3_10_7_Sthr_6.txt;30;3;3;94.937;1;1160;1156;4;4;1;1;1;1
IP3.exe;T21_small;small;instance_30_3_3_10_7_Sthr_7.txt;30;3;3;19.75;1;1146;1142;4;4;5;1;1;1
IP3.exe;T21_small;small;instance_30_3_3_10_7_Sthr_8.txt;30;3;3;77.562;1;985;981;4;4;4;1;1;1
IP3.exe;T21_small;small;instance_30_3_3_10_7_Sthr_9.txt;30;3;3;33.125;1;940;936;4;4;1;1;1;1
IP3.exe;T22_big;big;instance_30_3_4_10_8_Bthr_0.txt;30;3;4;12.703;1;825;821;4;4;3;1;1;1
IP3.exe;T22_big;big;instance_30_3_4_10_8_Bthr_1.txt;30;3;4;1.578;1;282;282;0;0;4;1;1;1
IP3.exe;T22_big;big;instance_30_3_4_10_8_Bthr_2.txt;30;3;4;6.625;1;550;547;3;3;4;1;1;1
IP3.exe;T22_big;big;instance_30_3_4_10_8_Bthr_3.txt;30;3;4;12.406;1;748;744;4;4;4;1;1;1
IP3.exe;T22_big;big;instance_30_3_4_10_8_Bthr_4.txt;30;3;4;11.187;1;854;849;5;5;3;1;1;1
IP3.exe;T22_big;big;instance_30_3_4_10_8_Bthr_5.txt;30;3;4;25.922;1;1022;1019;3;3;3;1;1;1
IP3.exe;T22_big;big;instance_30_3_4_10_8_Bthr_6.txt;30;3;4;13.797;1;877;872;5;5;2;1;1;1
IP3.exe;T22_big;big;instance_30_3_4_10_8_Bthr_7.txt;30;3;4;6.875;1;869;862;7;7;2;1;1;1
IP3.exe;T22_big;big;instance_30_3_4_10_8_Bthr_8.txt;30;3;4;34.391;1;1093;1089;4;4;2;1;1;1
IP3.exe;T22_big;big;instance_30_3_4_10_8_Bthr_9.txt;30;3;4;4.625;1;627;622;5;5;1;1;1;1
IP3.exe;T22_medium;medium;instance_30_3_4_10_8_Mthr_0.txt;30;3;4;6.703;1;488;483;5;5;4;1;1;1
IP3.exe;T22_medium;medium;instance_30_3_4_10_8_Mthr_1.txt;30;3;4;104.922;1;1392;1388;4;4;3;1;1;1
IP3.exe;T22_medium;medium;instance_30_3_4_10_8_Mthr_2.txt;30;3;4;2.25;1;462;456;6;6;2;1;1;1
IP3.exe;T22_medium;medium;instance_30_3_4_10_8_Mthr_3.txt;30;3;4;25.172;1;801;797;4;4;2;1;1;1
IP3.exe;T22_medium;medium;instance_30_3_4_10_8_Mthr_4.txt;30;3;4;23.782;1;898;893;5;5;4;1;1;1
IP3.exe;T22_medium;medium;instance_30_3_4_10_8_Mthr_5.txt;30;3;4;97.063;1;1175;1170;5;5;3;1;1;1
IP3.exe;T22_medium;medium;instance_30_3_4_10_8_Mthr_6.txt;30;3;4;73.094;1;749;745;4;4;4;1;1;1
IP3.exe;T22_medium;medium;instance_30_3_4_10_8_Mthr_7.txt;30;3;4;6.344;1;561;559;2;2;4;1;1;1
IP3.exe;T22_medium;medium;instance_30_3_4_10_8_Mthr_8.txt;30;3;4;17.015;1;790;785;5;5;4;1;1;1
IP3.exe;T22_medium;medium;instance_30_3_4_10_8_Mthr_9.txt;30;3;4;11.375;1;673;669;4;4;4;1;1;1
IP3.exe;T22_small;small;instance_30_3_4_10_8_Sthr_0.txt;30;3;4;17.781;1;896;889;7;7;2;1;1;1
IP3.exe;T22_small;small;instance_30_3_4_10_8_Sthr_1.txt;30;3;4;14.344;1;1034;1027;7;7;2;1;1;1
IP3.exe;T22_small;small;instance_30_3_4_10_8_Sthr_2.txt;30;3;4;62.672;1;878;874;4;4;5;1;1;1
IP3.exe;T22_small;small;instance_30_3_4_10_8_Sthr_3.txt;30;3;4;78.234;1;1115;1111;4;4;8;1;1;1
IP3.exe;T22_small;small;instance_30_3_4_10_8_Sthr_4.txt;30;3;4;181.782;1;1090;1085;5;5;4;1;1;1
IP3.exe;T22_small;small;instance_30_3_4_10_8_Sthr_5.txt;30;3;4;7.297;1;458;453;5;5;4;1;1;1
IP3.exe;T22_small;small;instance_30_3_4_10_8_Sthr_6.txt;30;3;4;94.672;1;688;684;4;4;5;1;1;1
IP3.exe;T22_small;small;instance_30_3_4_10_8_Sthr_7.txt;30;3;4;6.906;1;748;741;7;7;3;1;1;1
IP3.exe;T22_small;small;instance_30_3_4_10_8_Sthr_8.txt;30;3;4;10.531;1;628;622;6;6;4;1;1;1
IP3.exe;T22_small;small;instance_30_3_4_10_8_Sthr_9.txt;30;3;4;129.406;1;1340;1334;6;6;6;1;1;1
IP3.exe;T23_big;big;instance_30_3_5_10_13_Bthr_0.txt;30;3;5;109.125;1;742;735;7;7;5;1;1;1
IP3.exe;T23_big;big;instance_30_3_5_10_13_Bthr_1.txt;30;3;5;12.61;1;450;450;0;0;6;1;1;1
IP3.exe;T23_big;big;instance_30_3_5_10_13_Bthr_2.txt;30;3;5;120.078;1;980;973;7;7;5;1;1;1
IP3.exe;T23_big;big;instance_30_3_5_10_13_Bthr_3.txt;30;3;5;88.032;1;756;748;8;8;5;1;1;1
IP3.exe;T23_big;big;instance_30_3_5_10_13_Bthr_4.txt;30;3;5;109.36;1;621;614;7;7;5;1;1;1
IP3.exe;T23_big;big;instance_30_3_5_10_13_Bthr_5.txt;30;3;5;33.109;1;666;656;10;10;5;1;1;1
IP3.exe;T23_big;big;instance_30_3_5_10_13_Bthr_6.txt;30;3;5;39.219;1;561;557;4;4;7;1;1;1
IP3.exe;T23_big;big;instance_30_3_5_10_13_Bthr_7.txt;30;3;5;103.172;1;789;783;6;6;6;1;1;1
IP3.exe;T23_big;big;instance_30_3_5_10_13_Bthr_8.txt;30;3;5;123.109;1;745;741;4;4;7;1;1;1
IP3.exe;T23_big;big;instance_30_3_5_10_13_Bthr_9.txt;30;3;5;11.016;1;366;359;7;7;3;1;1;1
IP3.exe;T23_medium;medium;instance_30_3_5_10_13_Mthr_0.txt;30;3;5;93.282;1;754;747;7;7;7;1;1;1
IP3.exe;T23_medium;medium;instance_30_3_5_10_13_Mthr_1.txt;30;3;5;10.64;1;399;389;10;10;4;1;1;1
IP3.exe;T23_medium;medium;instance_30_3_5_10_13_Mthr_2.txt;30;3;5;474.937;1;908;898;10;10;5;1;1;1
IP3.exe;T23_medium;medium;instance_30_3_5_10_13_Mthr_3.txt;30;3;5;65.609;1;664;656;8;8;4;1;1;1
IP3.exe;T23_medium;medium;instance_30_3_5_10_13_Mthr_4.txt;30;3;5;156.281;1;1037;1027;10;10;3;1;1;1
IP3.exe;T23_medium;medium;instance_30_3_5_10_13_Mthr_5.txt;30;3;5;81.891;1;535;528;7;7;5;1;1;1
IP3.exe;T23_medium;medium;instance_30_3_5_10_13_Mthr_6.txt;30;3;5;207.578;1;924;915;9;9;6;1;1;1
IP3.exe;T23_medium;medium;instance_30_3_5_10_13_Mthr_7.txt;30;3;5;600.344;1;1399;1390;9;9;6;1;1;0
IP3.exe;T23_medium;medium;instance_30_3_5_10_13_Mthr_8.txt;30;3;5;413.157;1;1090;1081;9;9;3;1;1;1
IP3.exe;T23_medium;medium;instance_30_3_5_10_13_Mthr_9.txt;30;3;5;93.953;1;685;675;10;10;3;1;1;1
IP3.exe;T23_small;small;instance_30_3_5_10_13_Sthr_0.txt;30;3;5;113.219;1;876;866;10;10;3;1;1;1
IP3.exe;T23_small;small;instance_30_3_5_10_13_Sthr_1.txt;30;3;5;600.282;1;1225;1214;11;11;3;1;1;0
IP3.exe;T23_small;small;instance_30_3_5_10_13_Sthr_2.txt;30;3;5;600.25;1;1112;1102;10;10;4;1;1;0
IP3.exe;T23_small;small;instance_30_3_5_10_13_Sthr_3.txt;30;3;5;172.922;1;904;894;10;10;3;1;1;1
IP3.exe;T23_small;small;instance_30_3_5_10_13_Sthr_4.txt;30;3;5;28.578;1;599;590;9;9;6;1;1;1
IP3.exe;T23_small;small;instance_30_3_5_10_13_Sthr_5.txt;30;3;5;82.86;1;684;674;10;10;5;1;1;1
IP3.exe;T23_small;small;instance_30_3_5_10_13_Sthr_6.txt;30;3;5;111.063;1;767;758;9;9;5;1;1;1
IP3.exe;T23_small;small;instance_30_3_5_10_13_Sthr_7.txt;30;3;5;51.609;1;495;485;10;10;6;1;1;1
IP3.exe;T23_small;small;instance_30_3_5_10_13_Sthr_8.txt;30;3;5;110.906;1;514;504;10;10;3;1;1;1
IP3.exe;T23_small;small;instance_30_3_5_10_13_Sthr_9.txt;30;3;5;15.469;1;302;292;10;10;4;1;1;1
IP3.exe;T24_big;big;instance_30_4_4_10_10_Bthr_0.txt;30;4;4;2.062;1;237;237;0;0;2;1;1;1
IP3.exe;T24_big;big;instance_30_4_4_10_10_Bthr_1.txt;30;4;4;10.063;1;522;516;6;6;1;1;1;1
IP3.exe;T24_big;big;instance_30_4_4_10_10_Bthr_2.txt;30;4;4;14.484;1;574;574;0;0;2;1;1;1
IP3.exe;T24_big;big;instance_30_4_4_10_10_Bthr_3.txt;30;4;4;4.906;1;284;284;0;0;4;1;1;1
IP3.exe;T24_big;big;instance_30_4_4_10_10_Bthr_4.txt;30;4;4;7.516;1;489;483;6;6;2;1;1;1
IP3.exe;T24_big;big;instance_30_4_4_10_10_Bthr_5.txt;30;4;4;20.657;1;679;676;3;3;3;1;1;1
IP3.exe;T24_big;big;instance_30_4_4_10_10_Bthr_6.txt;30;4;4;28.297;1;727;723;4;4;2;1;1;1
IP3.exe;T24_big;big;instance_30_4_4_10_10_Bthr_7.txt;30;4;4;27.297;1;812;808;4;4;4;1;1;1
IP3.exe;T24_big;big;instance_30_4_4_10_10_Bthr_8.txt;30;4;4;15.343;1;638;635;3;3;3;1;1;1
IP3.exe;T24_big;big;instance_30_4_4_10_10_Bthr_9.txt;30;4;4;17.063;1;839;833;6;6;2;1;1;1
IP3.exe;T24_medium;medium;instance_30_4_4_10_10_Mthr_0.txt;30;4;4;30.969;1;626;624;2;2;4;1;1;1
IP3.exe;T24_medium;medium;instance_30_4_4_10_10_Mthr_1.txt;30;4;4;23.188;1;885;880;5;5;4;1;1;1
IP3.exe;T24_medium;medium;instance_30_4_4_10_10_Mthr_2.txt;30;4;4;12.39;1;502;496;6;6;3;1;1;1
IP3.exe;T24_medium;medium;instance_30_4_4_10_10_Mthr_3.txt;30;4;4;43.563;1;1109;1103;6;6;1;1;1;1
IP3.exe;T24_medium;medium;instance_30_4_4_10_10_Mthr_4.txt;30;4;4;10.984;1;564;558;6;6;2;1;1;1
IP3.exe;T24_medium;medium;instance_30_4_4_10_10_Mthr_5.txt;30;4;4;6.844;1;426;422;4;4;4;1;1;1
IP3.exe;T24_medium;medium;instance_30_4_4_10_10_Mthr_6.txt;30;4;4;27.078;1;632;628;4;4;5;1;1;1
IP3.exe;T24_medium;medium;instance_30_4_4_10_10_Mthr_7.txt;30;4;4;14.64;1;741;735;6;6;2;1;1;1
IP3.exe;T24_medium;medium;instance_30_4_4_10_10_Mthr_8.txt;30;4;4;53.437;1;1099;1093;6;6;1;1;1;1
IP3.exe;T24_medium;medium;instance_30_4_4_10_10_Mthr_9.txt;30;4;4;5.329;1;366;364;2;2;4;1;1;1
IP3.exe;T24_small;small;instance_30_4_4_10_10_Sthr_0.txt;30;4;4;26.406;1;627;621;6;6;2;1;1;1
IP3.exe;T24_small;small;instance_30_4_4_10_10_Sthr_1.txt;30;4;4;31.797;1;764;759;5;5;3;1;1;1
IP3.exe;T24_small;small;instance_30_4_4_10_10_Sthr_2.txt;30;4;4;7.078;1;481;474;7;7;3;1;1;1
IP3.exe;T24_small;small;instance_30_4_4_10_10_Sthr_3.txt;30;4;4;11.875;1;619;610;9;9;0;1;1;1
IP3.exe;T24_small;small;instance_30_4_4_10_10_Sthr_4.txt;30;4;4;10.172;1;416;410;6;6;3;1;1;1
IP3.exe;T24_small;small;instance_30_4_4_10_10_Sthr_5.txt;30;4;4;9.422;1;391;384;7;7;2;1;1;1
IP3.exe;T24_small;small;instance_30_4_4_10_10_Sthr_6.txt;30;4;4;105.812;1;872;866;6;6;3;1;1;1
IP3.exe;T24_small;small;instance_30_4_4_10_10_Sthr_7.txt;30;4;4;13.266;1;488;482;6;6;4;1;1;1
IP3.exe;T24_small;small;instance_30_4_4_10_10_Sthr_8.txt;30;4;4;41.625;1;901;894;7;7;1;1;1;1
IP3.exe;T24_small;small;instance_30_4_4_10_10_Sthr_9.txt;30;4;4;28.171;1;718;712;6;6;3;1;1;1
IP3.exe;T25_big;big;instance_30_5_5_10_14_Bthr_0.txt;30;5;5;19.75;1;388;388;0;0;5;1;1;1
IP3.exe;T25_big;big;instance_30_5_5_10_14_Bthr_1.txt;30;5;5;11.703;1;390;390;0;0;3;1;1;1
IP3.exe;T25_big;big;instance_30_5_5_10_14_Bthr_2.txt;30;5;5;97.766;1;736;736;0;0;2;1;1;1
IP3.exe;T25_big;big;instance_30_5_5_10_14_Bthr_3.txt;30;5;5;21.375;1;486;486;0;0;4;1;1;1
IP3.exe;T25_big;big;instance_30_5_5_10_14_Bthr_4.txt;30;5;5;47.219;1;646;646;0;0;3;1;1;1
IP3.exe;T25_big;big;instance_30_5_5_10_14_Bthr_5.txt;30;5;5;67.688;1;916;903;13;13;2;1;1;1
IP3.exe;T25_big;big;instance_30_5_5_10_14_Bthr_6.txt;30;5;5;16.063;1;333;333;0;0;5;1;1;1
IP3.exe;T25_big;big;instance_30_5_5_10_14_Bthr_7.txt;30;5;5;31.016;1;533;533;0;0;4;1;1;1
IP3.exe;T25_big;big;instance_30_5_5_10_14_Bthr_8.txt;30;5;5;29.187;1;495;495;0;0;5;1;1;1
IP3.exe;T25_big;big;instance_30_5_5_10_14_Bthr_9.txt;30;5;5;80.156;1;573;573;0;0;5;1;1;1
IP3.exe;T25_medium;medium;instance_30_5_5_10_14_Mthr_0.txt;30;5;5;22.859;1;436;432;4;4;6;1;1;1
IP3.exe;T25_medium;medium;instance_30_5_5_10_14_Mthr_1.txt;30;5;5;44.703;1;703;692;11;11;4;1;1;1
IP3.exe;T25_medium;medium;instance_30_5_5_10_14_Mthr_2.txt;30;5;5;11.969;1;375;364;11;11;5;1;1;1
IP3.exe;T25_medium;medium;instance_30_5_5_10_14_Mthr_3.txt;30;5;5;54.219;1;552;545;7;7;3;1;1;1
IP3.exe;T25_medium;medium;instance_30_5_5_10_14_Mthr_4.txt;30;5;5;117.953;1;736;726;10;10;1;1;1;1
IP3.exe;T25_medium;medium;instance_30_5_5_10_14_Mthr_5.txt;30;5;5;27.297;1;482;479;3;3;4;1;1;1
IP3.exe;T25_medium;medium;instance_30_5_5_10_14_Mthr_6.txt;30;5;5;67.875;1;539;531;8;8;3;1;1;1
IP3.exe;T25_medium;medium;instance_30_5_5_10_14_Mthr_7.txt;30;5;5;33.156;1;573;564;9;9;4;1;1;1
IP3.exe;T25_medium;medium;instance_30_5_5_10_14_Mthr_8.txt;30;5;5;14.25;1;354;354;0;0;6;1;1;1
IP3.exe;T25_medium;medium;instance_30_5_5_10_14_Mthr_9.txt;30;5;5;46.281;1;642;633;9;9;3;1;1;1
IP3.exe;T25_small;small;instance_30_5_5_10_14_Sthr_0.txt;30;5;5;61.422;1;452;445;7;7;4;1;1;1
IP3.exe;T25_small;small;instance_30_5_5_10_14_Sthr_1.txt;30;5;5;32.11;1;505;496;9;9;3;1;1;1
IP3.exe;T25_small;small;instance_30_5_5_10_14_Sthr_2.txt;30;5;5;13.765;1;412;403;9;9;3;1;1;1
IP3.exe;T25_small;small;instance_30_5_5_10_14_Sthr_3.txt;30;5;5;72.313;1;580;571;9;9;3;1;1;1
IP3.exe;T25_small;small;instance_30_5_5_10_14_Sthr_4.txt;30;5;5;25.969;1;495;486;9;9;5;1;1;1
IP3.exe;T25_small;small;instance_30_5_5_10_14_Sthr_5.txt;30;5;5;80.156;1;664;652;12;12;3;1;1;1
IP3.exe;T25_small;small;instance_30_5_5_10_14_Sthr_6.txt;30;5;5;17.719;1;395;386;9;9;3;1;1;1
IP3.exe;T25_small;small;instance_30_5_5_10_14_Sthr_7.txt;30;5;5;64.625;1;687;680;7;7;5;1;1;1
IP3.exe;T25_small;small;instance_30_5_5_10_14_Sthr_8.txt;30;5;5;28.297;1;497;490;7;7;5;1;1;1
IP3.exe;T25_small;small;instance_30_5_5_10_14_Sthr_9.txt;30;5;5;21.469;1;505;492;13;13;4;1;1;1
IP3.exe;T27_big;big;instance_40_3_3_10_5_Bthr_0.txt;40;3;3;29.797;1;1587;1586;1;1;4;1;1;1
IP3.exe;T27_big;big;instance_40_3_3_10_5_Bthr_1.txt;40;3;3;3.938;1;990;987;3;3;2;1;1;1
IP3.exe;T27_big;big;instance_40_3_3_10_5_Bthr_2.txt;40;3;3;22.516;1;2407;2405;2;2;2;1;1;1
IP3.exe;T27_big;big;instance_40_3_3_10_5_Bthr_3.txt;40;3;3;11.64;1;1960;1958;2;2;2;1;1;1
IP3.exe;T27_big;big;instance_40_3_3_10_5_Bthr_4.txt;40;3;3;4.141;1;1202;1200;2;2;2;1;1;1
IP3.exe;T27_big;big;instance_40_3_3_10_5_Bthr_5.txt;40;3;3;17.016;1;1359;1358;1;1;3;1;1;1
IP3.exe;T27_big;big;instance_40_3_3_10_5_Bthr_6.txt;40;3;3;1.141;1;781;777;4;4;2;1;1;1
IP3.exe;T27_big;big;instance_40_3_3_10_5_Bthr_7.txt;40;3;3;2.453;1;894;892;2;2;2;1;1;1
IP3.exe;T27_big;big;instance_40_3_3_10_5_Bthr_8.txt;40;3;3;4.625;1;1229;1226;3;3;2;1;1;1
IP3.exe;T27_big;big;instance_40_3_3_10_5_Bthr_9.txt;40;3;3;2.797;1;1067;1065;2;2;1;1;1;1
IP3.exe;T27_medium;medium;instance_40_3_3_10_5_Mthr_0.txt;40;3;3;3.25;1;859;855;4;4;0;1;1;1
IP3.exe;T27_medium;medium;instance_40_3_3_10_5_Mthr_1.txt;40;3;3;30.953;1;1919;1917;2;2;3;1;1;1
IP3.exe;T27_medium;medium;instance_40_3_3_10_5_Mthr_2.txt;40;3;3;7.094;1;1269;1266;3;3;1;1;1;1
IP3.exe;T27_medium;medium;instance_40_3_3_10_5_Mthr_3.txt;40;3;3;23.766;1;1885;1881;4;4;0;1;1;1
IP3.exe;T27_medium;medium;instance_40_3_3_10_5_Mthr_4.txt;40;3;3;4.578;1;1336;1332;4;4;0;1;1;1
IP3.exe;T27_medium;medium;instance_40_3_3_10_5_Mthr_5.txt;40;3;3;14.5;1;2213;2210;3;3;1;1;1;1
IP3.exe;T27_medium;medium;instance_40_3_3_10_5_Mthr_6.txt;40;3;3;9.078;1;1589;1587;2;2;3;1;1;1
IP3.exe;T27_medium;medium;instance_40_3_3_10_5_Mthr_7.txt;40;3;3;2.218;1;598;596;2;2;2;1;1;1
IP3.exe;T27_medium;medium;instance_40_3_3_10_5_Mthr_8.txt;40;3;3;1.609;1;860;856;4;4;0;1;1;1
IP3.exe;T27_medium;medium;instance_40_3_3_10_5_Mthr_9.txt;40;3;3;140.625;1;2499;2497;2;2;0;1;1;1
IP3.exe;T27_small;small;instance_40_3_3_10_5_Sthr_0.txt;40;3;3;4.843;1;856;855;1;1;6;1;1;1
IP3.exe;T27_small;small;instance_40_3_3_10_5_Sthr_1.txt;40;3;3;8.407;1;1664;1660;4;4;0;1;1;1
IP3.exe;T27_small;small;instance_40_3_3_10_5_Sthr_2.txt;40;3;3;10.5;1;1495;1493;2;2;4;1;1;1
IP3.exe;T27_small;small;instance_40_3_3_10_5_Sthr_3.txt;40;3;3;22.313;1;2428;2424;4;4;3;1;1;1
IP3.exe;T27_small;small;instance_40_3_3_10_5_Sthr_4.txt;40;3;3;34.688;1;2160;2157;3;3;1;1;1;1
IP3.exe;T27_small;small;instance_40_3_3_10_5_Sthr_5.txt;40;3;3;3.672;1;1345;1341;4;4;0;1;1;1
IP3.exe;T27_small;small;instance_40_3_3_10_5_Sthr_6.txt;40;3;3;63.907;1;2944;2940;4;4;3;1;1;1
IP3.exe;T27_small;small;instance_40_3_3_10_5_Sthr_7.txt;40;3;3;5.265;1;1354;1352;2;2;1;1;1;1
IP3.exe;T27_small;small;instance_40_3_3_10_5_Sthr_8.txt;40;3;3;8.203;1;1488;1485;3;3;1;1;1;1
IP3.exe;T27_small;small;instance_40_3_3_10_5_Sthr_9.txt;40;3;3;6.156;1;1646;1643;3;3;0;1;1;1
IP3.exe;T34_big;big;instance_50_3_3_10_6_Bthr_0.txt;50;3;3;14.859;1;1928;1924;4;4;3;1;1;1
IP3.exe;T34_big;big;instance_50_3_3_10_6_Bthr_1.txt;50;3;3;108.594;1;2995;2991;4;4;1;1;1;1
IP3.exe;T34_big;big;instance_50_3_3_10_6_Bthr_2.txt;50;3;3;15.656;1;2402;2399;3;3;2;1;1;1
IP3.exe;T34_big;big;instance_50_3_3_10_6_Bthr_3.txt;50;3;3;9.578;1;2037;2032;5;5;2;1;1;1
IP3.exe;T34_big;big;instance_50_3_3_10_6_Bthr_4.txt;50;3;3;11.046;1;1658;1655;3;3;2;1;1;1
IP3.exe;T34_big;big;instance_50_3_3_10_6_Bthr_5.txt;50;3;3;45.875;1;2820;2818;2;2;3;1;1;1
IP3.exe;T34_big;big;instance_50_3_3_10_6_Bthr_6.txt;50;3;3;5.172;1;1586;1581;5;5;0;1;1;1
IP3.exe;T34_big;big;instance_50_3_3_10_6_Bthr_7.txt;50;3;3;12.265;1;1714;1710;4;4;5;1;1;1
IP3.exe;T34_big;big;instance_50_3_3_10_6_Bthr_8.txt;50;3;3;4.469;1;1095;1093;2;2;2;1;1;1
IP3.exe;T34_big;big;instance_50_3_3_10_6_Bthr_9.txt;50;3;3;58.515;1;3072;3070;2;2;6;1;1;1
IP3.exe;T34_medium;medium;instance_50_3_3_10_6_Mthr_0.txt;50;3;3;113.172;1;3080;3078;2;2;4;1;1;1
IP3.exe;T34_medium;medium;instance_50_3_3_10_6_Mthr_1.txt;50;3;3;30.188;1;2556;2552;4;4;0;1;1;1
IP3.exe;T34_medium;medium;instance_50_3_3_10_6_Mthr_2.txt;50;3;3;5.859;1;1837;1832;5;5;1;1;1;1
IP3.exe;T34_medium;medium;instance_50_3_3_10_6_Mthr_3.txt;50;3;3;16.375;1;1317;1314;3;3;4;1;1;1
IP3.exe;T34_medium;medium;instance_50_3_3_10_6_Mthr_4.txt;50;3;3;149;1;3207;3204;3;3;1;1;1;1
IP3.exe;T34_medium;medium;instance_50_3_3_10_6_Mthr_5.txt;50;3;3;27.656;1;1982;1978;4;4;1;1;1;1
IP3.exe;T34_medium;medium;instance_50_3_3_10_6_Mthr_6.txt;50;3;3;429.532;1;3590;3586;4;4;1;1;1;1
IP3.exe;T34_medium;medium;instance_50_3_3_10_6_Mthr_7.txt;50;3;3;8.813;1;1525;1521;4;4;3;1;1;1
IP3.exe;T34_medium;medium;instance_50_3_3_10_6_Mthr_8.txt;50;3;3;32.281;1;2389;2386;3;3;3;1;1;1
IP3.exe;T34_medium;medium;instance_50_3_3_10_6_Mthr_9.txt;50;3;3;21.266;1;1861;1858;3;3;2;1;1;1
IP3.exe;T34_small;small;instance_50_3_3_10_6_Sthr_0.txt;50;3;3;88.906;1;2662;2658;4;4;0;1;1;1
IP3.exe;T34_small;small;instance_50_3_3_10_6_Sthr_1.txt;50;3;3;130.079;1;2956;2953;3;3;4;1;1;1
IP3.exe;T34_small;small;instance_50_3_3_10_6_Sthr_2.txt;50;3;3;9.969;1;1917;1912;5;5;0;1;1;1
IP3.exe;T34_small;small;instance_50_3_3_10_6_Sthr_3.txt;50;3;3;13.265;1;1473;1470;3;3;1;1;1;1
IP3.exe;T34_small;small;instance_50_3_3_10_6_Sthr_4.txt;50;3;3;2.782;1;1035;1030;5;5;3;1;1;1
IP3.exe;T34_small;small;instance_50_3_3_10_6_Sthr_5.txt;50;3;3;15.906;1;1798;1794;4;4;5;1;1;1
IP3.exe;T34_small;small;instance_50_3_3_10_6_Sthr_6.txt;50;3;3;7.782;1;1834;1829;5;5;0;1;1;1
IP3.exe;T34_small;small;instance_50_3_3_10_6_Sthr_7.txt;50;3;3;108.719;1;2899;2895;4;4;0;1;1;1
IP3.exe;T34_small;small;instance_50_3_3_10_6_Sthr_8.txt;50;3;3;4.688;1;1177;1172;5;5;2;1;1;1
IP3.exe;T34_small;small;instance_50_3_3_10_6_Sthr_9.txt;50;3;3;17.688;1;1927;1922;5;5;1;1;1;1
IP3.exe;T39_big;big;instance_60_3_4_10_9_Bthr_0.txt;60;3;4;26.765;1;1673;1668;5;5;7;1;1;1
IP3.exe;T39_big;big;instance_60_3_4_10_9_Bthr_1.txt;60;3;4;601.047;1;4940;4934;6;6;7;1;1;0
IP3.exe;T39_big;big;instance_60_3_4_10_9_Bthr_2.txt;60;3;4;600.438;1;3973;3968;5;5;10;1;1;0
IP3.exe;T39_big;big;instance_60_3_4_10_9_Bthr_3.txt;60;3;4;468.672;1;4189;4182;7;7;2;1;1;1
IP3.exe;T39_big;big;instance_60_3_4_10_9_Bthr_4.txt;60;3;4;290.5;1;3260;3254;6;6;3;1;1;1
IP3.exe;T39_big;big;instance_60_3_4_10_9_Bthr_5.txt;60;3;4;57.891;1;1715;1709;6;6;3;1;1;1
IP3.exe;T39_big;big;instance_60_3_4_10_9_Bthr_6.txt;60;3;4;600.469;1;4296;4290;6;6;4;1;1;0
IP3.exe;T39_big;big;instance_60_3_4_10_9_Bthr_7.txt;60;3;4;67.282;1;2383;2377;6;6;4;1;1;1
IP3.exe;T39_big;big;instance_60_3_4_10_9_Bthr_8.txt;60;3;4;450.625;1;2768;2763;5;5;8;1;1;1
IP3.exe;T39_big;big;instance_60_3_4_10_9_Bthr_9.txt;60;3;4;600.375;1;3713;3708;5;5;8;1;1;0
IP3.exe;T39_medium;medium;instance_60_3_4_10_9_Mthr_0.txt;60;3;4;186.031;1;3584;3577;7;7;3;1;1;1
IP3.exe;T39_medium;medium;instance_60_3_4_10_9_Mthr_1.txt;60;3;4;284.64;1;2898;2893;5;5;7;1;1;1
IP3.exe;T39_medium;medium;instance_60_3_4_10_9_Mthr_2.txt;60;3;4;320.5;1;3481;3474;7;7;3;1;1;1
IP3.exe;T39_medium;medium;instance_60_3_4_10_9_Mthr_3.txt;60;3;4;600.954;1;4873;4865;8;8;8;1;1;0
IP3.exe;T39_medium;medium;instance_60_3_4_10_9_Mthr_4.txt;60;3;4;231.297;1;2058;2052;6;6;6;1;1;1
IP3.exe;T39_medium;medium;instance_60_3_4_10_9_Mthr_5.txt;60;3;4;83.703;1;2491;2485;6;6;5;1;1;1
IP3.exe;T39_medium;medium;instance_60_3_4_10_9_Mthr_6.txt;60;3;4;10.422;1;1070;1064;6;6;3;1;1;1
IP3.exe;T39_medium;medium;instance_60_3_4_10_9_Mthr_7.txt;60;3;4;21.5;1;1872;1865;7;7;2;1;1;1
IP3.exe;T39_medium;medium;instance_60_3_4_10_9_Mthr_8.txt;60;3;4;600.406;1;3658;3652;6;6;8;1;1;0
IP3.exe;T39_medium;medium;instance_60_3_4_10_9_Mthr_9.txt;60;3;4;144.531;1;1765;1759;6;6;4;1;1;1
IP3.exe;T39_small;small;instance_60_3_4_10_9_Sthr_0.txt;60;3;4;600.594;1;4772;4764;8;8;6;1;1;0
IP3.exe;T39_small;small;instance_60_3_4_10_9_Sthr_1.txt;60;3;4;601.266;1;4983;4977;6;6;14;1;1;0
IP3.exe;T39_small;small;instance_60_3_4_10_9_Sthr_2.txt;60;3;4;25.422;1;1885;1877;8;8;5;1;1;1
IP3.exe;T39_small;small;instance_60_3_4_10_9_Sthr_3.txt;60;3;4;454.734;1;4076;4069;7;7;2;1;1;1
IP3.exe;T39_small;small;instance_60_3_4_10_9_Sthr_4.txt;60;3;4;210.437;1;2835;2829;6;6;4;1;1;1
IP3.exe;T39_small;small;instance_60_3_4_10_9_Sthr_5.txt;60;3;4;600.625;1;5199;5192;7;7;6;1;1;0
IP3.exe;T39_small;small;instance_60_3_4_10_9_Sthr_6.txt;60;3;4;52.234;1;2185;2178;7;7;2;1;1;1
IP3.exe;T39_small;small;instance_60_3_4_10_9_Sthr_7.txt;60;3;4;92.766;1;3001;2994;7;7;2;1;1;1
IP3.exe;T39_small;small;instance_60_3_4_10_9_Sthr_8.txt;60;3;4;46.609;1;1010;1004;6;6;5;1;1;1
IP3.exe;T39_small;small;instance_60_3_4_10_9_Sthr_9.txt;60;3;4;26.047;1;1401;1395;6;6;5;1;1;1
IP3.exe;T40_big;big;instance_60_3_5_10_11_Bthr_0.txt;60;3;5;601.031;1;4884;4878;6;6;18;1;1;0
IP3.exe;T40_big;big;instance_60_3_5_10_11_Bthr_1.txt;60;3;5;278.375;1;2688;2681;7;7;8;1;1;1
IP3.exe;T40_big;big;instance_60_3_5_10_11_Bthr_2.txt;60;3;5;237.656;1;2268;2259;9;9;7;1;1;1
IP3.exe;T40_big;big;instance_60_3_5_10_11_Bthr_3.txt;60;3;5;168.812;1;1813;1806;7;7;7;1;1;1
IP3.exe;T40_big;big;instance_60_3_5_10_11_Bthr_4.txt;60;3;5;38.921;1;1205;1197;8;8;5;1;1;1
IP3.exe;T40_big;big;instance_60_3_5_10_11_Bthr_5.txt;60;3;5;570.344;1;2910;2903;7;7;6;1;1;1
IP3.exe;T40_big;big;instance_60_3_5_10_11_Bthr_6.txt;60;3;5;505.047;1;2543;2536;7;7;7;1;1;1
IP3.exe;T40_big;big;instance_60_3_5_10_11_Bthr_7.txt;60;3;5;600.953;1;3733;3725;8;8;11;1;1;0
IP3.exe;T40_big;big;instance_60_3_5_10_11_Bthr_8.txt;60;3;5;39.406;1;1891;1881;10;10;5;1;1;1
IP3.exe;T40_big;big;instance_60_3_5_10_11_Bthr_9.txt;60;3;5;176.609;1;2438;2430;8;8;5;1;1;1
IP3.exe;T40_medium;medium;instance_60_3_5_10_11_Mthr_0.txt;60;3;5;175.469;1;1506;1498;8;8;4;1;1;1
IP3.exe;T40_medium;medium;instance_60_3_5_10_11_Mthr_1.txt;60;3;5;225.453;1;2060;2053;7;7;8;1;1;1
IP3.exe;T40_medium;medium;instance_60_3_5_10_11_Mthr_2.txt;60;3;5;600.281;1;2186;2178;8;8;8;1;1;0
IP3.exe;T40_medium;medium;instance_60_3_5_10_11_Mthr_3.txt;60;3;5;209.375;1;1718;1711;7;7;8;1;1;1
IP3.exe;T40_medium;medium;instance_60_3_5_10_11_Mthr_4.txt;60;3;5;77.141;1;1398;1390;8;8;8;1;1;1
IP3.exe;T40_medium;medium;instance_60_3_5_10_11_Mthr_5.txt;60;3;5;600.343;1;2913;2904;9;9;6;1;1;0
IP3.exe;T40_medium;medium;instance_60_3_5_10_11_Mthr_6.txt;60;3;5;600.5;1;3047;3039;8;8;8;1;1;0
IP3.exe;T40_medium;medium;instance_60_3_5_10_11_Mthr_7.txt;60;3;5;600.39;1;2815;2807;8;8;10;1;1;0
IP3.exe;T40_medium;medium;instance_60_3_5_10_11_Mthr_8.txt;60;3;5;446.547;1;2427;2419;8;8;4;1;1;1
IP3.exe;T40_medium;medium;instance_60_3_5_10_11_Mthr_9.txt;60;3;5;600.906;1;3724;3718;6;6;21;1;1;0
IP3.exe;T40_small;small;instance_60_3_5_10_11_Sthr_0.txt;60;3;5;600.579;1;3028;3019;9;9;3;1;1;0
IP3.exe;T40_small;small;instance_60_3_5_10_11_Sthr_1.txt;60;3;5;600.359;1;3004;2997;7;7;18;1;1;0
IP3.exe;T40_small;small;instance_60_3_5_10_11_Sthr_2.txt;60;3;5;35.953;1;1104;1096;8;8;3;1;1;1
IP3.exe;T40_small;small;instance_60_3_5_10_11_Sthr_3.txt;60;3;5;600.969;1;4257;4247;10;10;5;1;1;0
IP3.exe;T40_small;small;instance_60_3_5_10_11_Sthr_4.txt;60;3;5;600.719;1;4321;4312;9;9;13;1;1;0
IP3.exe;T40_small;small;instance_60_3_5_10_11_Sthr_5.txt;60;3;5;600;0; ; ; ; ; ; ; 
IP3.exe;T40_small;small;instance_60_3_5_10_11_Sthr_6.txt;60;3;5;600.531;1;3621;3612;9;9;11;1;1;0
IP3.exe;T40_small;small;instance_60_3_5_10_11_Sthr_7.txt;60;3;5;600.937;1;3960;3951;9;9;15;1;1;0
IP3.exe;T40_small;small;instance_60_3_5_10_11_Sthr_8.txt;60;3;5;557.844;1;2434;2426;8;8;6;1;1;1
IP3.exe;T40_small;small;instance_60_3_5_10_11_Sthr_9.txt;60;3;5;600.312;1;2606;2596;10;10;8;1;1;0
IP3.exe;T44_big;big;instance_70_3_5_10_12_Bthr_0.txt;70;3;5;157.547;1;1882;1873;9;9;6;1;1;1
IP3.exe;T44_big;big;instance_70_3_5_10_12_Bthr_1.txt;70;3;5;600.797;1;4067;4058;9;9;11;1;1;0
IP3.exe;T44_big;big;instance_70_3_5_10_12_Bthr_2.txt;70;3;5;603.735;1;17465;17455;10;10;32;1;1;0
IP3.exe;T44_big;big;instance_70_3_5_10_12_Bthr_3.txt;70;3;5;601.359;1;3448;3439;9;9;13;1;1;0
IP3.exe;T44_big;big;instance_70_3_5_10_12_Bthr_4.txt;70;3;5;140.547;1;1792;1784;8;8;6;1;1;1
IP3.exe;T44_big;big;instance_70_3_5_10_12_Bthr_5.txt;70;3;5;600.562;1;3535;3526;9;9;6;1;1;0
IP3.exe;T44_big;big;instance_70_3_5_10_12_Bthr_6.txt;70;3;5;601.281;1;5137;5129;8;8;25;1;1;0
IP3.exe;T44_big;big;instance_70_3_5_10_12_Bthr_7.txt;70;3;5;600;0; ; ; ; ; ; ; 
IP3.exe;T44_big;big;instance_70_3_5_10_12_Bthr_8.txt;70;3;5;602.516;1;21237;21227;10;10;29;1;1;0
IP3.exe;T44_big;big;instance_70_3_5_10_12_Bthr_9.txt;70;3;5;600.297;1;2410;2401;9;9;8;1;1;0
IP3.exe;T44_medium;medium;instance_70_3_5_10_12_Mthr_0.txt;70;3;5;303.359;1;2391;2382;9;9;8;1;1;1
IP3.exe;T44_medium;medium;instance_70_3_5_10_12_Mthr_1.txt;70;3;5;600.656;1;3953;3943;10;10;19;1;1;0
IP3.exe;T44_medium;medium;instance_70_3_5_10_12_Mthr_2.txt;70;3;5;601.515;1;4873;4864;9;9;21;1;1;0
IP3.exe;T44_medium;medium;instance_70_3_5_10_12_Mthr_3.txt;70;3;5;600;0; ; ; ; ; ; ; 
IP3.exe;T44_medium;medium;instance_70_3_5_10_12_Mthr_4.txt;70;3;5;600.312;1;2368;2358;10;10;4;1;1;0
IP3.exe;T44_medium;medium;instance_70_3_5_10_12_Mthr_5.txt;70;3;5;600.422;1;2755;2746;9;9;7;1;1;0
IP3.exe;T44_medium;medium;instance_70_3_5_10_12_Mthr_6.txt;70;3;5;600.594;1;3147;3138;9;9;14;1;1;0
IP3.exe;T44_medium;medium;instance_70_3_5_10_12_Mthr_7.txt;70;3;5;601.672;1;14357;14346;11;11;26;1;1;0
IP3.exe;T44_medium;medium;instance_70_3_5_10_12_Mthr_8.txt;70;3;5;600.968;1;3874;3864;10;10;10;1;1;0
IP3.exe;T44_medium;medium;instance_70_3_5_10_12_Mthr_9.txt;70;3;5;601.625;1;17080;17070;10;10;38;1;1;0
IP3.exe;T44_small;small;instance_70_3_5_10_12_Sthr_0.txt;70;3;5;603.844;1;10230;10219;11;11;29;1;1;0
IP3.exe;T44_small;small;instance_70_3_5_10_12_Sthr_1.txt;70;3;5;600.266;1;2483;2473;10;10;3;1;1;0
IP3.exe;T44_small;small;instance_70_3_5_10_12_Sthr_2.txt;70;3;5;601.156;1;3924;3913;11;11;6;1;1;0
IP3.exe;T44_small;small;instance_70_3_5_10_12_Sthr_3.txt;70;3;5;601.438;1;5210;5199;11;11;17;1;1;0
IP3.exe;T44_small;small;instance_70_3_5_10_12_Sthr_4.txt;70;3;5;601.687;1;5769;5758;11;11;24;1;1;0
IP3.exe;T44_small;small;instance_70_3_5_10_12_Sthr_5.txt;70;3;5;600.437;1;3170;3160;10;10;13;1;1;0
IP3.exe;T44_small;small;instance_70_3_5_10_12_Sthr_6.txt;70;3;5;601.094;1;5479;5468;11;11;23;1;1;0
IP3.exe;T44_small;small;instance_70_3_5_10_12_Sthr_7.txt;70;3;5;600;0; ; ; ; ; ; ; 
IP3.exe;T44_small;small;instance_70_3_5_10_12_Sthr_8.txt;70;3;5;601.844;1;8738;8727;11;11;39;1;1;0
IP3.exe;T44_small;small;instance_70_3_5_10_12_Sthr_9.txt;70;3;5;600.546;1;2966;2957;9;9;11;1;1;0
IP3.exe;T45_big;big;instance_70_4_4_10_9_Bthr_0.txt;70;4;4;49.422;1;2352;2347;5;5;4;1;1;1
IP3.exe;T45_big;big;instance_70_4_4_10_9_Bthr_1.txt;70;4;4;410.016;1;4024;4021;3;3;6;1;1;1
IP3.exe;T45_big;big;instance_70_4_4_10_9_Bthr_2.txt;70;4;4;603.687;1;8001;7994;7;7;12;1;1;0
IP3.exe;T45_big;big;instance_70_4_4_10_9_Bthr_3.txt;70;4;4;180.079;1;3519;3513;6;6;3;1;1;1
IP3.exe;T45_big;big;instance_70_4_4_10_9_Bthr_4.txt;70;4;4;487.516;1;4374;4369;5;5;5;1;1;1
IP3.exe;T45_big;big;instance_70_4_4_10_9_Bthr_5.txt;70;4;4;147.016;1;2513;2508;5;5;3;1;1;1
IP3.exe;T45_big;big;instance_70_4_4_10_9_Bthr_6.txt;70;4;4;187.375;1;4293;4288;5;5;2;1;1;1
IP3.exe;T45_big;big;instance_70_4_4_10_9_Bthr_7.txt;70;4;4;175.328;1;3363;3356;7;7;1;1;1;1
IP3.exe;T45_big;big;instance_70_4_4_10_9_Bthr_8.txt;70;4;4;600.844;1;19251;19244;7;7;40;1;1;0
IP3.exe;T45_big;big;instance_70_4_4_10_9_Bthr_9.txt;70;4;4;30.25;1;1851;1846;5;5;5;1;1;1
IP3.exe;T45_medium;medium;instance_70_4_4_10_9_Mthr_0.txt;70;4;4;151.235;1;2878;2873;5;5;5;1;1;1
IP3.exe;T45_medium;medium;instance_70_4_4_10_9_Mthr_1.txt;70;4;4;279.75;1;2622;2616;6;6;7;1;1;1
IP3.exe;T45_medium;medium;instance_70_4_4_10_9_Mthr_2.txt;70;4;4;70.39;1;2580;2573;7;7;4;1;1;1
IP3.exe;T45_medium;medium;instance_70_4_4_10_9_Mthr_3.txt;70;4;4;575.813;1;3903;3895;8;8;2;1;1;1
IP3.exe;T45_medium;medium;instance_70_4_4_10_9_Mthr_4.txt;70;4;4;136.265;1;4139;4132;7;7;0;1;1;1
IP3.exe;T45_medium;medium;instance_70_4_4_10_9_Mthr_5.txt;70;4;4;63.968;1;2598;2593;5;5;4;1;1;1
IP3.exe;T45_medium;medium;instance_70_4_4_10_9_Mthr_6.txt;70;4;4;562.938;1;3453;3447;6;6;9;1;1;1
IP3.exe;T45_medium;medium;instance_70_4_4_10_9_Mthr_7.txt;70;4;4;603.75;1;8904;8896;8;8;17;1;1;0
IP3.exe;T45_medium;medium;instance_70_4_4_10_9_Mthr_8.txt;70;4;4;119.422;1;3997;3989;8;8;3;1;1;1
IP3.exe;T45_medium;medium;instance_70_4_4_10_9_Mthr_9.txt;70;4;4;140.657;1;2718;2712;6;6;6;1;1;1
IP3.exe;T45_small;small;instance_70_4_4_10_9_Sthr_0.txt;70;4;4;600;0; ; ; ; ; ; ; 
IP3.exe;T45_small;small;instance_70_4_4_10_9_Sthr_1.txt;70;4;4;25.39;1;2497;2489;8;8;2;1;1;1
IP3.exe;T45_small;small;instance_70_4_4_10_9_Sthr_2.txt;70;4;4;600.438;1;11734;11726;8;8;32;1;1;0
IP3.exe;T45_small;small;instance_70_4_4_10_9_Sthr_3.txt;70;4;4;600.235;1;2871;2863;8;8;11;1;1;0
IP3.exe;T45_small;small;instance_70_4_4_10_9_Sthr_4.txt;70;4;4;600;0; ; ; ; ; ; ; 
IP3.exe;T45_small;small;instance_70_4_4_10_9_Sthr_5.txt;70;4;4;600.609;1;3694;3688;6;6;3;1;1;0
IP3.exe;T45_small;small;instance_70_4_4_10_9_Sthr_6.txt;70;4;4;13.531;1;1035;1028;7;7;4;1;1;1
IP3.exe;T45_small;small;instance_70_4_4_10_9_Sthr_7.txt;70;4;4;258.609;1;4164;4159;5;5;2;1;1;1
IP3.exe;T45_small;small;instance_70_4_4_10_9_Sthr_8.txt;70;4;4;352.984;1;4753;4746;7;7;0;1;1;1
IP3.exe;T45_small;small;instance_70_4_4_10_9_Sthr_9.txt;70;4;4;103.235;1;4233;4225;8;8;4;1;1;1
IP3.exe;T46_big;big;instance_70_4_5_10_14_Bthr_0.txt;70;4;5;602.985;1;17318;17306;12;12;30;1;1;0
IP3.exe;T46_big;big;instance_70_4_5_10_14_Bthr_1.txt;70;4;5;358.281;1;2978;2968;10;10;6;1;1;1
IP3.exe;T46_big;big;instance_70_4_5_10_14_Bthr_2.txt;70;4;5;602.985;1;16932;16919;13;13;26;1;1;0
IP3.exe;T46_big;big;instance_70_4_5_10_14_Bthr_3.txt;70;4;5;287.641;1;2665;2656;9;9;8;1;1;1
IP3.exe;T46_big;big;instance_70_4_5_10_14_Bthr_4.txt;70;4;5;600.391;1;2039;2028;11;11;4;1;1;0
IP3.exe;T46_big;big;instance_70_4_5_10_14_Bthr_5.txt;70;4;5;239.593;1;2042;2033;9;9;9;1;1;1
IP3.exe;T46_big;big;instance_70_4_5_10_14_Bthr_6.txt;70;4;5;600.984;1;2984;2975;9;9;7;1;1;0
IP3.exe;T46_big;big;instance_70_4_5_10_14_Bthr_7.txt;70;4;5;605.641;1;5128;5118;10;10;26;1;1;0
IP3.exe;T46_big;big;instance_70_4_5_10_14_Bthr_8.txt;70;4;5;568.5;1;2313;2303;10;10;7;1;1;1
IP3.exe;T46_big;big;instance_70_4_5_10_14_Bthr_9.txt;70;4;5;270.328;1;2104;2094;10;10;5;1;1;1
IP3.exe;T46_medium;medium;instance_70_4_5_10_14_Mthr_0.txt;70;4;5;100.547;1;1610;1600;10;10;6;1;1;1
IP3.exe;T46_medium;medium;instance_70_4_5_10_14_Mthr_1.txt;70;4;5;600.891;1;3429;3417;12;12;13;1;1;0
IP3.exe;T46_medium;medium;instance_70_4_5_10_14_Mthr_2.txt;70;4;5;601.406;1;12978;12965;13;13;29;1;1;0
IP3.exe;T46_medium;medium;instance_70_4_5_10_14_Mthr_3.txt;70;4;5;184.875;1;2283;2271;12;12;6;1;1;1
IP3.exe;T46_medium;medium;instance_70_4_5_10_14_Mthr_4.txt;70;4;5;601.969;1;3711;3701;10;10;20;1;1;0
IP3.exe;T46_medium;medium;instance_70_4_5_10_14_Mthr_5.txt;70;4;5;98.75;1;1384;1378;6;6;8;1;1;1
IP3.exe;T46_medium;medium;instance_70_4_5_10_14_Mthr_6.txt;70;4;5;35.891;1;1021;1011;10;10;4;1;1;1
IP3.exe;T46_medium;medium;instance_70_4_5_10_14_Mthr_7.txt;70;4;5;591.234;1;2449;2440;9;9;7;1;1;1
IP3.exe;T46_medium;medium;instance_70_4_5_10_14_Mthr_8.txt;70;4;5;388.688;1;2638;2628;10;10;5;1;1;1
IP3.exe;T46_medium;medium;instance_70_4_5_10_14_Mthr_9.txt;70;4;5;600.812;1;3051;3042;9;9;13;1;1;0
IP3.exe;T46_small;small;instance_70_4_5_10_14_Sthr_0.txt;70;4;5;601.046;1;7604;7592;12;12;31;1;1;0
IP3.exe;T46_small;small;instance_70_4_5_10_14_Sthr_1.txt;70;4;5;600.328;1;1866;1856;10;10;9;1;1;0
IP3.exe;T46_small;small;instance_70_4_5_10_14_Sthr_2.txt;70;4;5;601;1;2996;2983;13;13;8;1;1;0
IP3.exe;T46_small;small;instance_70_4_5_10_14_Sthr_3.txt;70;4;5;495.297;1;2063;2053;10;10;10;1;1;1
IP3.exe;T46_small;small;instance_70_4_5_10_14_Sthr_4.txt;70;4;5;545.062;1;2558;2548;10;10;7;1;1;1
IP3.exe;T46_small;small;instance_70_4_5_10_14_Sthr_5.txt;70;4;5;601.172;1;9648;9635;13;13;19;1;1;0
IP3.exe;T46_small;small;instance_70_4_5_10_14_Sthr_6.txt;70;4;5;601.484;1;10012;9999;13;13;17;1;1;0
IP3.exe;T46_small;small;instance_70_4_5_10_14_Sthr_7.txt;70;4;5;603.453;1;3686;3673;13;13;3;1;1;0
IP3.exe;T46_small;small;instance_70_4_5_10_14_Sthr_8.txt;70;4;5;600.547;1;2567;2554;13;13;10;1;1;0
IP3.exe;T46_small;small;instance_70_4_5_10_14_Sthr_9.txt;70;4;5;429.515;1;2280;2270;10;10;9;1;1;1
